aa lang=Afar
ab lang=Abkhaz
ae lang=Avestan
af lang=Afrikaans
ak lang=Akan
am lang=Amharic
an lang=Aragonese
ar lang=Arabic
as lang=Assamese
av lang=Avar
ay lang=Aymara
az lang=Azerbaijani
ba lang=Bashkir
be lang=Belarusian
bg lang=Bulgarian
bh lang=Bihari
bi lang=Bislama
bm lang=Bambara
bn lang=Bengali
bo lang=Tibetan
br lang=Breton
ca lang=Catalan
ce lang=Chechen
ch lang=Chamorro
co lang=Corsican
cr lang=Cree
cs lang=Czech
cu lang=Old
cv lang=Chuvash
cy lang=Welsh
da lang=Danish
de lang=German
dv lang=Dhivehi
dz lang=Dzongkha
ee lang=Ewe
el lang=Greek
en lang=English
eo lang=Esperanto
es lang=Spanish
et lang=Estonian
eu lang=Basque
fa lang=Persian
ff lang=Fula
fi lang=Finnish
fj lang=Fijian
fo lang=Faroese
fr lang=French
fy lang=West
ga lang=Irish
gd lang=Scottish
gl lang=Galician
gn lang=Guaraní
gu lang=Gujarati
gv lang=Manx
ha lang=Hausa
he lang=Hebrew
hi lang=Hindi
ho lang=Hiri
ht lang=Haitian
hu lang=Hungarian
hy lang=Armenian
hz lang=Herero
ia lang=Interlingua
id lang=Indonesian
ie lang=Interlingue
ig lang=Igbo
ii lang=Sichuan
ik lang=Inupiaq
io lang=Ido
is lang=Icelandic
it lang=Italian
iu lang=Inuktitut
ja lang=Japanese
jv lang=Javanese
ka lang=Georgian
kg lang=Kongo
ki lang=Kikuyu
kj lang=Kwanyama
kk lang=Kazakh
kl lang=Greenlandic
km lang=Khmer
kn lang=Kannada
ko lang=Korean
kr lang=Kanuri
ks lang=Kashmiri
kw lang=Cornish
ky lang=Kyrgyz
la lang=Latin
lb lang=Luxembourgish
lg lang=Luganda
li lang=Limburgish
ln lang=Lingala
lo lang=Lao
lt lang=Lithuanian
lu lang=Luba-Katanga
lv lang=Latvian
mg lang=Malagasy
mh lang=Marshallese
mi lang=Maori
mk lang=Macedonian
ml lang=Malayalam
mn lang=Mongolian
mr lang=Marathi
ms lang=Malay
mt lang=Maltese
my lang=Burmese
na lang=Nauruan
nb lang=Norwegian
nd lang=Northern
ne lang=Nepali
ng lang=Ndonga
nl lang=Dutch
nn lang=Norwegian
no lang=Norwegian
nr lang=Southern
nv lang=Navajo
ny lang=Chichewa
oc lang=Occitan
oj lang=Ojibwe
om lang=Oromo
or lang=Oriya
os lang=Ossetian
pa lang=Punjabi
pi lang=Pali
pl lang=Polish
ps lang=Pashto
pt lang=Portuguese
qu lang=Quechua
rm lang=Romansch
ro lang=Romanian
ru lang=Russian
rw lang=Rwanda-Rundi
sa lang=Sanskrit
sc lang=Sardinian
sd lang=Sindhi
se lang=Northern
sg lang=Sango
sh lang=Serbo-Croatian
si lang=Sinhalese
sk lang=Slovak
sl lang=Slovene
sm lang=Samoan
sn lang=Shona
so lang=Somali
sq lang=Albanian
ss lang=Swazi
st lang=Sotho
su lang=Sundanese
sv lang=Swedish
sw lang=Swahili
ta lang=Tamil
te lang=Telugu
tg lang=Tajik
th lang=Thai
ti lang=Tigrinya
tk lang=Turkmen
tl lang=Tagalog
tn lang=Tswana
to lang=Tongan
tr lang=Turkish
ts lang=Tsonga
tt lang=Tatar
ty lang=Tahitian
ug lang=Uyghur
uk lang=Ukrainian
ur lang=Urdu
uz lang=Uzbek
ve lang=Venda
vi lang=Vietnamese
vo lang=Volapük
wa lang=Walloon
wo lang=Wolof
xh lang=Xhosa
yi lang=Yiddish
yo lang=Yoruba
za lang=Zhuang
zh lang=Chinese
zu lang=Zulu
Three - letter lang=codeso
These lang=codes
aaa lang=Ghotuo
aab lang=Alumu-Tesu
aac lang=Ari
aad lang=Amal
aaf lang=Aranadan
aag lang=Ambrak
aah lang=Abu'
aai lang=Arifama-Miniafia
aak lang=Ankave
aal lang=Afade
aan lang=Anambé
aap lang=Pará
aaq lang=Penobscot
aas lang=Aasax
aau lang=Abau
aaw lang=Solong
aax lang=Mandobo
aaz lang=Amarasi
aba lang=Abé
abb lang=Bankon
abc lang=Ambala
abd lang=Camarines
abe lang=Abenaki
abf lang=Abai
abg lang=Abaga
abh lang=Tajiki
abi lang=Abidji
abj lang=Aka-Bea
abl lang=Abung
abm lang=Abanyom
abn lang=Abua
abo lang=Abon
abp lang=Abenlen
abq lang=Abaza
abr lang=Abron
abs lang=Ambonese
abt lang=Ambulas
abu lang=Abure
abv lang=Baharna
abw lang=Pal
abx lang=Inabaknon
aby lang=Aneme
abz lang=Abui
aca lang=Achagua
acb lang=Áncá
acd lang=Gikyode
ace lang=Acehnese
ach lang=Acholi
aci lang=Aka-Cari
ack lang=Aka-Kora
acl lang=Akar-Bale
acm lang=Iraqi
acn lang=Achang
acp lang=Eastern
acr lang=Achi
acs lang=Acroá
acu lang=Achuar
acv lang=Achumawi
acw lang=Hijazi
acx lang=Omani
acy lang=Cypriot
acz lang=Acheron
ada lang=Adangme
adb lang=Adabe
add lang=Dzodinka
ade lang=Adele
adf lang=Dhofari
adg lang=Andegerebinha
adh lang=Adhola
adi lang=Adi
adj lang=Adioukrou
adl lang=Galo
adn lang=Adang
ado lang=Abu
adp lang=Adap
adq lang=Adangbe
adr lang=Adonara
ads lang=Adamorobe
adt lang=Adnyamathanha
adu lang=Aduge
adw lang=Amondawa
ady lang=Adyghe
adz lang=Adzera
aea lang=Areba
aeb lang=Tunisian
aed lang=Argentine
aee lang=Northeast
aek lang=Haeke
ael lang=Ambele
aem lang=Arem
aen lang=Armenian
aeq lang=Aer
aer lang=Eastern
aes lang=Alsea
aeu lang=Akeu
aew lang=Ambakich
aey lang=Amele
aez lang=Aeka
afb lang=Gulf
afd lang=Andai
afe lang=Putukwam
afg lang=Afghan
afh lang=Afrihili
afi lang=Akrukay
afk lang=Nanubae
afn lang=Defaka
afo lang=Eloyi
afp lang=Tapei
afs lang=Afro-Seminole
aft lang=Afitti
afu lang=Awutu
afz lang=Obokuitai
aga lang=Aguano
agb lang=Legbo
agc lang=Agatu
agd lang=Agarabi
age lang=Angal
agf lang=Arguni
agg lang=Angor
agh lang=Ngelima
agi lang=Agariya
agj lang=Argobba
agk lang=Isarog
agl lang=Fembe
agm lang=Angaataha
agn lang=Agutaynen
ago lang=Tainae
agq lang=Aghem
agr lang=Aguaruna
ags lang=Esimbi
agt lang=Central
agu lang=Aguacateca
agv lang=Remontado
agw lang=Kahua
agx lang=Aghul
agy lang=Southern
agz lang=Mount
aha lang=Ahanta
ahb lang=Axamb
ahg lang=Qimant
ahh lang=Aghu
ahi lang=Tiagbamrin
ahk lang=Akha
ahl lang=Igo
ahm lang=Mobumrin
ahn lang=Àhàn
aho lang=Ahom
ahp lang=Aproumu
ahr lang=Ahirani
ahs lang=Ashe
aht lang=Ahtna
aia lang=Arosi
aib lang=Aynu
aic lang=Ainbai
aid lang=Alngith
aie lang=Amara
aif lang=Agi
aig lang=Antigua
aih lang=Ai-Cham
aii lang=Assyrian
aij lang=Lishanid
aik lang=Ake
ail lang=Aimele
aim lang=Aimol
ain lang=Ainu
aio lang=Aiton
aip lang=Burumakok
air lang=Airoran
ait lang=Arikem
aiw lang=Aari
aix lang=Aighon
aiy lang=Ali
aja lang=Aja
ajg lang=Adja
aji lang=Ajië
ajn lang=Andajin
ajp lang=South
ajw lang=Ajawa
ajz lang=Amri
akb lang=Angkola
akc lang=Mpur
akd lang=Ukpet-Ehom
ake lang=Akawaio
akf lang=Akpa
akg lang=Anakalangu
akh lang=Angal
aki lang=Aiome
akj lang=Jeru
akk lang=Akkadian
akl lang=Aklanon
akm lang=Aka-Bo
ako lang=Akurio
akp lang=Siwu
akq lang=Ak
akr lang=Araki
aks lang=Akaselem
akt lang=Akolet
aku lang=Akum
akv lang=Akhvakh
akw lang=Akwa
akx lang=Aka-Kede
aky lang=Aka-Kol
akz lang=Alabama
ala lang=Alago
alc lang=Kawésqar
ald lang=Alladian
ale lang=Aleut
alf lang=Alege
alh lang=Alawa
ali lang=Amaimon
alj lang=Alangan
alk lang=Alak
all lang=Allar
alm lang=Amblong
alo lang=Larike-Wakasihu
alp lang=Alune
alq lang=Algonquin
alr lang=Alutor
alt lang=Southern
alu lang='Are'are
alw lang=Alaba
alx lang=Amol
aly lang=Alyawarr
alz lang=Alur
ama lang=Amanayé
amb lang=Ambo
amc lang=Amahuaca
ame lang=Yanesha'
amf lang=Hamer-Banna
amg lang=Amurdag
ami lang=Amis
amj lang=Amdang
amk lang=Ambai
aml lang=War-Jaintia
amm lang=Ama
amn lang=Amanab
amo lang=Amo
amp lang=Alamblak
amq lang=Amahai
amr lang=Amarakaeri
ams lang=Southern
amt lang=Amto
amu lang=Guerrero
amv lang=Ambelau
amw lang=Western
amx lang=Anmatyerre
amy lang=Ami
amz lang=Atampaya
ana lang=Andaqui
anb lang=Andoa
anc lang=Ngas
and lang=Ansus
ane lang=Xârâcùù
anf lang=Animere
ang lang=Old
anh lang=Nend
ani lang=Andi
anj lang=Anor
ank lang=Goemai
anl lang=Anu
anm lang=Anal
ann lang=Obolo
ano lang=Andoque
anp lang=Angika
anq lang=Jarawa
anr lang=Andh
ans lang=Anserma
ant lang=Antakarinya
anu lang=Anuak
anv lang=Denya
anw lang=Anaang
anx lang=Andra-Hus
any lang=Anyi
anz lang=Anem
aoa lang=Angolar
aob lang=Abom
aoc lang=Pemon
aod lang=Andarum
aoe lang=Angal
aof lang=Bragat
aog lang=Angoram
aoi lang=Anindilyakwa
aoj lang=Mufian
aok lang=Arhö
aol lang=Alor
aom lang=Ömie
aon lang=Bumbita
aor lang=Aore
aos lang=Taikat
aot lang=Atong
aou lang=A'ou
aox lang=Atorada
aoz lang=Uab
apb lang=Sa'a
apc lang=North
apd lang=Sudanese
ape lang=Bukiyip
apf lang=Pahanan
apg lang=Ampanang
aph lang=Athpare
api lang=Apiaká
apj lang=Jicarilla
apk lang=Plains
apl lang=Lipan
apm lang=Chiricahua
apn lang=Apinayé
apo lang=Ambul
app lang=Apma
apq lang=A-Pucikwar
apr lang=Arop-Lokep
aps lang=Arop-Sissano
apt lang=Apatani
apu lang=Apurinã
apv lang=Alapmunte
apw lang=Western
apx lang=Aputai
apy lang=Apalaí
apz lang=Safeyoka
aqc lang=Archi
aqd lang=Ampari
aqg lang=Arigidi
aqm lang=Atohwaim
aqn lang=Northern
aqp lang=Atakapa
aqr lang=Arhâ
aqt lang=Angaité
aqz lang=Akuntsu
arc lang=Aramaic
ard lang=Arabana
are lang=Western
arh lang=Arhuaco
ari lang=Arikara
arj lang=Arapaso
ark lang=Arikapú
arl lang=Arabela
arn lang=Mapudungun
aro lang=Araona
arp lang=Arapaho
arq lang=Algerian
arr lang=Arara-Karo
ars lang=Najdi
aru lang=Arua
arv lang=Arbore
arw lang=Arawak
arx lang=Aruá
ary lang=Moroccan
arz lang=Egyptian
asa lang=Pare
asb lang=Assiniboine
asc lang=Casuarina
ase lang=American
asf lang=Auslan
asg lang=Cishingini
ash lang=Abishira
asi lang=Buruwai
asj lang=Nsari
ask lang=Ashkun
asl lang=Asilulu
asn lang=Xingú
aso lang=Dano
asp lang=Algerian
asq lang=Austrian
asr lang=Asuri
ass lang=Ipulo
ast lang=Asturian
asu lang=Tocantins
asv lang=Asoa
asw lang=Australian
asx lang=Muratayak
asy lang=Yaosakor
asz lang=As
ata lang=Pele-Ata
atb lang=Zaiwa
atc lang=Atsahuaca
atd lang=Ata
ate lang=Atemble
atg lang=Okpela
ati lang=Attié
atj lang=Atikamekw
atk lang=Ati
atl lang=Mount
atm lang=Ata
ato lang=Atong
atp lang=Pudtol
atq lang=Aralle-Tabulahan
atr lang=Waimiri-Atroari
ats lang=Gros
att lang=Pamplona
atu lang=Reel
atv lang=Northern
atw lang=Atsugewi
atx lang=Arutani
aty lang=Aneityum
atz lang=Arta
aua lang=Asumboa
aub lang=Alugu
auc lang=Huaorani
aud lang=Anuta
aug lang=Aguna
auh lang=Aushi
aui lang=Anuki
auj lang=Awjila
auk lang=Heyo
aul lang=Aulua
aum lang=Asu
aun lang=Molmo
auo lang=Auyokawa
aup lang=Makayam
auq lang=Anus
aur lang=Aruek
aut lang=Austral
auu lang=Auye
auw lang=Awyi
aux lang=Aurá
auy lang=Auyana
auz lang=Uzbeki
avb lang=Avau
avd lang=Alviri-Vidari
avi lang=Avikam
avk lang=Kotava
avm lang=Angkamuthi
avn lang=Avatime
avo lang=Agavotaguerra
avs lang=Aushiri
avt lang=Au
avu lang=Avokaya
avv lang=Avá-Canoeiro
awa lang=Awadhi
awb lang=Awa
awc lang=Cicipu
awe lang=Awetí
awg lang=Anguthimri
awh lang=Awbono
awi lang=Aekyom
awk lang=Awabakal
awm lang=Arawum
awn lang=Awngi
awo lang=Awak
awr lang=Awera
aws lang=South
awt lang=Araweté
awu lang=Central
awv lang=Jair
aww lang=Awun
awx lang=Awara
awy lang=Edera
axb lang=Abipon
axe lang=Ayerrerenge
axg lang=Mato
axk lang=Aka
axl lang=Lower
axm lang=Middle
axx lang=Xaragure
aya lang=Awar
ayb lang=Ayizo
ayd lang=Ayabadhu
aye lang=Ayere
ayg lang=Nyanga
ayi lang=Leyigha
ayk lang=Akuku
ayl lang=Libyan
ayn lang=Yemeni
ayo lang=Ayoreo
ayp lang=North
ayq lang=Ayi
ays lang=Sorsogon
ayt lang=Bataan
ayu lang=Ayu
ayy lang=Tayabas
ayz lang=Maybrat
aza lang=Azha
azd lang=Eastern
azg lang=San
azm lang=Ipalapa
azn lang=Western
azo lang=Awing
azt lang=Faire
azz lang=Highland
baa lang=Babatana
bab lang=Bainouk-Gunyuño
bac lang=Badui
bae lang=Baré
baf lang=Nubaca
bag lang=Tuki
bah lang=Bahamian
baj lang=Barakai
bal lang=Baluchi
ban lang=Balinese
bao lang=Waimaha
bap lang=Bantawa
bar lang=Bavarian
bas lang=Basaa
bau lang=Badanchi
bav lang=Babungo
baw lang=Bambili-Bambui
bax lang=Bamum
bay lang=Batuley
bba lang=Baatonum
bbb lang=Barai
bbc lang=Toba
bbd lang=Bau
bbe lang=Bangba
bbf lang=Baibai
bbg lang=Barama
bbh lang=Bugan
bbi lang=Barombi
bbj lang=Ghomala'
bbk lang=Babanki
bbl lang=Bats
bbm lang=Babango
bbn lang=Uneapa
bbo lang=Konabéré
bbp lang=West
bbq lang=Bamali
bbr lang=Girawa
bbs lang=Bakpinka
bbt lang=Mburku
bbu lang=Bakulung
bbv lang=Karnai
bbw lang=Baba
bbx lang=Bubia
bby lang=Befang
bca lang=Central
bcb lang=Bainouk-Samik
bcd lang=North
bce lang=Bamenyam
bcf lang=Bamu
bcg lang=Baga
bch lang=Bariai
bci lang=Baoule
bcj lang=Bardi
bck lang=Bunaba
bcl lang=Bikol
bcm lang=Banoni
bcn lang=Bibaali
bco lang=Kaluli
bcp lang=Bali
bcq lang=Bench
bcr lang=Babine-Witsuwit'en
bcs lang=Kohumono
bct lang=Bendi
bcu lang=Biliau
bcv lang=Shoo-Minda-Nye
bcw lang=Bana
bcy lang=Bacama
bcz lang=Bainouk-Gunyaamolo
bda lang=Bayot
bdb lang=Basap
bdc lang=Emberá-Baudó
bdd lang=Bunama
bde lang=Bade
bdf lang=Biage
bdg lang=Bonggi
bdh lang=Tara
bdi lang=Burun
bdj lang=Bai
bdk lang=Budukh
bdl lang=Indonesian
bdm lang=Buduma
bdn lang=Baldemu
bdo lang=Morom
bdp lang=Bende
bdq lang=Bahnar
bdr lang=West
bds lang=Burunge
bdt lang=Bokoto
bdu lang=Oroko
bdv lang=Bodo
bdw lang=Baham
bdx lang=Budong-Budong
bdy lang=Bandjalang
bdz lang=Badeshi
bea lang=Beaver
beb lang=Bebele
bec lang=Iceve-Maci
bed lang=Bedoanas
bee lang=Byangsi
bef lang=Benabena
beg lang=Belait
beh lang=Biali
bei lang=Bekati'
bej lang=Beja
bek lang=Bebeli
bem lang=Bemba
beo lang=Beami
bep lang=Besoa
beq lang=Beembe
bes lang=Besme
bet lang=Guiberoua
beu lang=Blagar
bev lang=Daloa
bew lang=Betawi
bex lang=Jur
bey lang=Akuwagel
bez lang=Kibena
bfa lang=Bari
bfb lang=Pauri
bfc lang=Northern
bfd lang=Bafut
bfe lang=Betaf
bff lang=Bofi
bfg lang=Busang
bfh lang=Blafe
bfi lang=British
bfj lang=Bafanji
bfk lang=Ban
bfl lang=Banda-Ndélé
bfm lang=Mmen
bfn lang=Bunak
bfo lang=Malba
bfp lang=Beba
bfq lang=Badaga
bfr lang=Bazigar
bfs lang=Southern
bft lang=Balti
bfu lang=Gahri
bfw lang=Bondo
bfx lang=Bantayanon
bfy lang=Bagheli
bfz lang=Mahasu
bga lang=Gwamhi-Wuri
bgb lang=Bobongko
bgc lang=Haryanvi
bgd lang=Rathwi
bge lang=Bauria
bgf lang=Bangandu
bgg lang=Bugun
bgi lang=Giangan
bgj lang=Bangolan
bgk lang=Bit
bgl lang=Bo
bgo lang=Baga
bgq lang=Bagri
bgr lang=Bawm
bgs lang=Tagabawa
bgt lang=Bughotu
bgu lang=Mbongno
bgv lang=Warkay-Bipim
bgw lang=Bhatri
bgx lang=Balkan
bgy lang=Benggoi
bgz lang=Banggai
bha lang=Bharia
bhb lang=Bhili
bhc lang=Biga
bhd lang=Bhadrawahi
bhe lang=Bhaya
bhf lang=Odiai
bhg lang=Binandere
bhh lang=Bukhari
bhi lang=Bhilali
bhj lang=Bahing
bhl lang=Bimin
bhm lang=Bathari
bhn lang=Bohtan
bho lang=Bhojpuri
bhp lang=Bima
bhq lang=Tukang
bhs lang=Buwal
bht lang=Bhattiyali
bhu lang=Bhunjia
bhv lang=Bahau
bhw lang=Biak
bhx lang=Bhalay
bhy lang=Bhele
bhz lang=Bada
bia lang=Badimaya
bib lang=Bissa
bic lang=Bikaru
bid lang=Bidiyo
bie lang=Bepour
bif lang=Biafada
big lang=Biangai
bij lang=Kwanka
bil lang=Bile
bim lang=Bimoba
bin lang=Edo
bio lang=Nai
bip lang=Bila
biq lang=Bipi
bir lang=Bisorio
bit lang=Berinomo
biu lang=Biete
biv lang=Southern
biw lang=Kol
bix lang=Bijori
biy lang=Birhor
biz lang=Baloi
bja lang=Budza
bjb lang=Barngarla
bjc lang=Bariji
bje lang=Biao-Jiao
bjf lang=Barzani
bjg lang=Bidyogo
bjh lang=Bahinemo
bji lang=Burji
bjj lang=Kannauji
bjk lang=Barok
bjl lang=Bulu
bjm lang=Bajelani
bjn lang=Banjarese
bjo lang=Mid-Southern
bjp lang=Fanamaket
bjr lang=Binumarien
bjs lang=Bajan
bjt lang=Balanta-Ganja
bju lang=Busuu
bjv lang=Bedjond
bjw lang=Bakwé
bjx lang=Banao
bjy lang=Bayali
bjz lang=Baruga
bka lang=Kyak
bkc lang=Baka
bkd lang=Binukid
bkf lang=Beeke
bkg lang=Buraka
bkh lang=Bakoko
bki lang=Baki
bkj lang=Pande
bkk lang=Brokskat
bkl lang=Berik
bkm lang=Kom
bkn lang=Bukitan
bko lang=Kwa'
bkp lang=Iboko
bkq lang=Bakairí
bkr lang=Bakumpai
bks lang=Masbate
bkt lang=Boloki
bku lang=Buhid
bkv lang=Bekwarra
bkw lang=Bekwel
bkx lang=Baikeno
bky lang=Bokyi
bkz lang=Bungku
bla lang=Blackfoot
blb lang=Bilua
blc lang=Bella
bld lang=Bolango
ble lang=Balanta-Kentohe
blf lang=Buol
blg lang=Balau
blh lang=Kuwaa
bli lang=Bolia
blj lang=Bolongan
blk lang=Pa'o
bll lang=Biloxi
blm lang=Beli
bln lang=Southern
blo lang=Anii
blp lang=Blablanga
blq lang=Baluan-Pam
blr lang=Blang
bls lang=Balaesang
blt lang=Tai
blv lang=Kibala
blw lang=Balangao
blx lang=Mag-Indi
bly lang=Notre
blz lang=Balantak
bma lang=Lame
bmb lang=Bembe
bmc lang=Biem
bmd lang=Baga
bme lang=Limassa
bmf lang=Bom
bmg lang=Bamwe
bmh lang=Kein
bmi lang=Bagirmi
bmj lang=Bote-Majhi
bmk lang=Ghayavi
bml lang=Bomboli
bmn lang=Bina
bmo lang=Bambalang
bmp lang=Bulgebi
bmq lang=Bomu
bmr lang=Muinane
bmt lang=Biao
bmu lang=Somba-Siawari
bmv lang=Bum
bmw lang=Bomwali
bmx lang=Baimak
bmz lang=Baramu
bna lang=Bonerate
bnb lang=Bookan
bnd lang=Banda
bne lang=Bintauna
bnf lang=Masiwang
bng lang=Benga
bni lang=Bangi
bnj lang=Eastern
bnk lang=Bierebo
bnl lang=Boon
bnm lang=Batanga
bnn lang=Bunun
bno lang=Asi
bnp lang=Bola
bnq lang=Bantik
bnr lang=Butmas-Tur
bns lang=Bundeli
bnu lang=Bentong
bnv lang=Beneraf
bnw lang=Bisis
bnx lang=Bangubangu
bny lang=Bintulu
bnz lang=Beezen
boa lang=Bora
bob lang=Aweer
boe lang=Mundabli
bof lang=Bolon
bog lang=Bamako
boh lang=North
boi lang=Barbareño
boj lang=Anjam
bok lang=Bonjo
bol lang=Bole
bom lang=Berom
bon lang=Bine
boo lang=Tiemacèwè
bop lang=Bonkiman
boq lang=Bogaya
bor lang=Borôro
bot lang=Bongo
bou lang=Bondei
bov lang=Tuwuli
bow lang=Rema
box lang=Buamu
boy lang=Bodo
boz lang=Tiéyaxo
bpa lang=Dakaka
bpd lang=Banda-Banda
bpg lang=Bonggo
bph lang=Botlikh
bpi lang=Bagupi
bpj lang=Binji
bpk lang=Orowe
bpl lang=Broome
bpm lang=Biyom
bpn lang=Dzao
bpo lang=Anasi
bpp lang=Kaure
bpq lang=Banda
bpr lang=Koronadal
bps lang=Sarangani
bpt lang=Barrow
bpu lang=Bongu
bpv lang=Bian
bpx lang=Palya
bpy lang=Bishnupriya
bpz lang=Bilba
bqa lang=Tchumbuli
bqb lang=Bagusa
bqc lang=Boko
bqd lang=Bung
bqf lang=Baga
bqg lang=Bago-Kusuntu
bqh lang=Baima
bqi lang=Bakhtiari
bqj lang=Bandial
bqk lang=Banda-Mbrès
bql lang=Bilakura
bqm lang=Wumboko
bqn lang=Bulgarian
bqo lang=Balo
bqp lang=Busa
bqq lang=Biritai
bqr lang=Burusu
bqs lang=Bosngun
bqt lang=Bamukumbit
bqu lang=Boguru
bqv lang=Begbere-Ejar
bqw lang=Buru
bqx lang=Baangi
bqy lang=Bengkala
bqz lang=Bakaka
bra lang=Braj
brb lang=Lave
brc lang=Berbice
brd lang=Baraamu
brf lang=Bera
brg lang=Baure
brh lang=Brahui
bri lang=Mokpwe
brj lang=Bieria
brk lang=Birgid
brl lang=Birwa
brm lang=Barambu
brn lang=Boruca
bro lang=Brokkat
brp lang=Barapasi
brq lang=Breri
brr lang=Birao
brs lang=Baras
brt lang=Bitare
bru lang=Eastern
brv lang=Western
brw lang=Bellari
brx lang=Bodo
bry lang=Burui
brz lang=Bilbil
bsa lang=Abinomn
bsb lang=Brunei
bsc lang=Bassari
bse lang=Wushi
bsf lang=Bauchi
bsg lang=Bashkardi
bsh lang=Kamkata-viri
bsi lang=Bassossi
bsj lang=Bangwinji
bsk lang=Burushaski
bsl lang=Basa-Gumna
bsm lang=Busami
bsn lang=Barasana
bso lang=Buso
bsp lang=Baga
bsq lang=Bassa
bsr lang=Bassa-Kontagora
bss lang=Akoose
bst lang=Basketo
bsu lang=Bahonsuai
bsv lang=Baga
bsw lang=Baiso
bsx lang=Yangkam
bsy lang=Sabah
bta lang=Bata
btc lang=Bati
btd lang=Dairi
bte lang=Gamo-Ningi
btf lang=Birgit
btg lang=Gagnoa
bth lang=Biatah
bti lang=Burate
btj lang=Bacanese
btm lang=Mandailing
btn lang=Ratagnon
bto lang=Iriga
btp lang=Budibud
btq lang=Batek
btr lang=Baetora
bts lang=Simalungun
btt lang=Bete-Bendi
btu lang=Batu
btv lang=Bateri
btw lang=Butuanon
btx lang=Karo
bty lang=Bobot
btz lang=Alas-Kluet
bua lang=Buryat
bub lang=Bua
bud lang=Ntcham
bue lang=Beothuk
buf lang=Bushoong
bug lang=Buginese
buh lang=Younuo
bui lang=Bongili
buj lang=Basa-Gurmana
buk lang=Bukawa
bum lang=Bulu
bun lang=Sherbro
buo lang=Terei
bup lang=Busoa
buq lang=Brem
bus lang=Bokobaru
but lang=Bungain
buu lang=Budu
buv lang=Bun
buw lang=Bubi
bux lang=Boghom
buy lang=Mmani
bva lang=Barein
bvb lang=Bube
bvc lang=Baelelea
bvd lang=Baeggu
bve lang=Berau
bvf lang=Boor
bvg lang=Bonkeng
bvh lang=Bure
bvi lang=Belanda
bvj lang=Baan
bvk lang=Bukat
bvl lang=Bolivian
bvm lang=Bamunka
bvn lang=Buna
bvo lang=Bolgo
bvp lang=Bumang
bvq lang=Birri
bvr lang=Burarra
bvt lang=Bati
bvu lang=Bukit
bvv lang=Baniva
bvw lang=Boga
bvx lang=Babole
bvy lang=Baybayanon
bvz lang=Bauzi
bwa lang=Bwatoo
bwb lang=Namosi-Naitasiri-Serua
bwc lang=Bwile
bwd lang=Bwaidoka
bwe lang=Bwe
bwf lang=Boselewa
bwg lang=Barwe
bwh lang=Bishuo
bwi lang=Baniwa
bwj lang=Láá
bwk lang=Bauwaki
bwl lang=Bwela
bwm lang=Biwat
bwn lang=Wunai
bwo lang=Shinasha
bwp lang=Mandobo
bwq lang=Southern
bwr lang=Bura
bws lang=Bomboma
bwt lang=Bafaw
bwu lang=Buli
bww lang=Bwa
bwx lang=Bu-Nao
bwy lang=Cwi
bwz lang=Bwisi
bxa lang=Bauro
bxb lang=Belanda
bxc lang=Molengue
bxd lang=Pela
bxe lang=Ongota
bxf lang=Bilur
bxg lang=Bangala
bxh lang=Buhutu
bxi lang=Pirlatapa
bxj lang=Bayungu
bxk lang=Bukusu
bxl lang=Jalkunan
bxn lang=Burduna
bxo lang=Barikanchi
bxp lang=Bebil
bxq lang=Beele
bxs lang=Busam
bxv lang=Berakou
bxw lang=Banka
bxz lang=Binahari
bya lang=Palawan
byb lang=Bikya
byc lang=Ubaghara
byd lang=Benyadu'
bye lang=Pouye
byf lang=Bete
byg lang=Baygo
byh lang=Bujhyal
byi lang=Buyu
byj lang=Binawa
byk lang=Biao
byl lang=Bayono
bym lang=Bidyara
byn lang=Blin
byo lang=Biyo
byp lang=Bumaji
byq lang=Basay
byr lang=Baruya
bys lang=Burak
byt lang=Berti
byv lang=Medumba
byw lang=Belhariya
byx lang=Qaqet
byz lang=Banaro
bza lang=Bandi
bzb lang=Andio
bzd lang=Bribri
bze lang=Jenaama
bzf lang=Boikin
bzg lang=Babuza
bzh lang=Mapos
bzi lang=Bisu
bzj lang=Belizean
bzk lang=Nicaraguan
bzl lang=Boano
bzm lang=Bolondo
bzn lang=Boano
bzo lang=Bozaba
bzp lang=Kemberano
bzq lang=Buli
bzr lang=Biri
bzs lang=Brazilian
bzu lang=Burmeso
bzv lang=Bebe
bzw lang=Basa
bzx lang=Hainyaxo
bzy lang=Obanliku
bzz lang=Evant
caa lang=Ch'orti'
cab lang=Garifuna
cac lang=Chuj
cad lang=Caddo
cae lang=Laalaa
caf lang=Southern
cag lang=Nivaclé
cah lang=Cahuarano
caj lang=Chané
cak lang=Kaqchikel
cal lang=Carolinian
cam lang=Cemuhî
can lang=Chambri
cao lang=Chácobo
cap lang=Chipaya
caq lang=Car
car lang=Galibi
cas lang=Tsimané
cav lang=Cavineña
caw lang=Callawalla
cax lang=Chiquitano
cay lang=Cayuga
caz lang=Canichana
cbb lang=Cabiyarí
cbc lang=Carapana
cbd lang=Carijona
cbg lang=Chimila
cbi lang=Chachi
cbj lang=Ede
cbk lang=Chavacano
cbl lang=Bualkhaw
cbn lang=Nyah
cbo lang=Izora
cbq lang=Shuba
cbr lang=Cashibo-Cacataibo
cbs lang=Cashinahua
cbt lang=Chayahuita
cbu lang=Candoshi-Shapra
cbv lang=Cacua
cbw lang=Kinabalian
cby lang=Carabayo
cca lang=Cauca
ccc lang=Chamicuro
ccd lang=Cafundó
cce lang=Chopi
ccg lang=Chamba
cch lang=Atsam
ccj lang=Kasanga
ccl lang=Cutchi-Swahili
ccm lang=Malaccan
cco lang=Comaltepec
ccp lang=Chakma
ccr lang=Cacaopera
cda lang=Choni
cde lang=Chenchu
cdf lang=Chiru
cdh lang=Chambeali
cdi lang=Chodri
cdj lang=Churahi
cdm lang=Chepang
cdn lang=Chaudangsi
cdo lang=Min
cdr lang=Cinda-Regi-Tiyal
cds lang=Chadian
cdy lang=Chadong
cdz lang=Koda
cea lang=Lower
ceb lang=Cebuano
ceg lang=Chamacoco
cen lang=Cen
cet lang=Centúúm
cfa lang=Dijim-Bwilim
cfd lang=Cara
cfg lang=Como
cfm lang=Falam
cga lang=Changriwa
cgc lang=Kagayanen
cgg lang=Rukiga
cgk lang=Chocangaca
chb lang=Chibcha
chc lang=Catawba
chd lang=Highland
chf lang=Tabasco
chg lang=Chagatai
chh lang=Chinook
chj lang=Ojitlán
chk lang=Chuukese
chl lang=Cahuilla
chm lang=Eastern
chn lang=Chinook
cho lang=Choctaw
chp lang=Chipewyan
chq lang=Quiotepec
chr lang=Cherokee
cht lang=Cholón
chw lang=Chuabo
chx lang=Chantyal
chy lang=Cheyenne
chz lang=Ozumacín
cia lang=Cia-Cia
cib lang=Ci
cic lang=Chickasaw
cid lang=Chimariko
cie lang=Cineni
cih lang=Chinali
cik lang=Chitkuli
cim lang=Cimbrian
cin lang=Cinta
cip lang=Chiapanec
cir lang=Tiri
ciy lang=Chaima
cja lang=Western
cje lang=Chru
cjh lang=Upper
cji lang=Chamalal
cjk lang=Chokwe
cjm lang=Eastern
cjn lang=Chenapian
cjo lang=Ashéninka
cjp lang=Cabécar
cjs lang=Shor
cjv lang=Chuave
cjy lang=Jin
ckb lang=Central
ckh lang=Chak
ckl lang=Cibak
ckn lang=Kaang
cko lang=Anufo
ckq lang=Kajakse
ckr lang=Kairak
cks lang=Tayo
ckt lang=Chukchi
cku lang=Koasati
ckv lang=Kavalan
ckx lang=Caka
cky lang=Cakfem-Mushere
ckz lang=Cakchiquel-Quiché
cla lang=Ron
clc lang=Chilcotin
cld lang=Chaldean
cle lang=Lealao
clh lang=Chilisso
cli lang=Chakali
clj lang=Laitu
clk lang=Idu
cll lang=Chala
clm lang=Klallam
clo lang=Lowland
clt lang=Lautu
clu lang=Caluyanun
clw lang=Chulym
cly lang=Eastern
cma lang=Maa
cme lang=Cerma
cmg lang=Classical
cmi lang=Emberá-Chamí
cml lang=Campalagian
cmm lang=Michigamea
cmn lang=Mandarin
cmo lang=Central
cmr lang=Mro
cms lang=Messapic
cmt lang=Camtho
cna lang=Changthang
cnb lang=Chinbon
cnc lang=Côông
cng lang=Northern
cnh lang=Lai
cni lang=Asháninka
cnk lang=Khumi
cnl lang=Lalana
cno lang=Con
cns lang=Central
cnt lang=Tepetotutla
cnu lang=Chenoua
cnw lang=Ngawn
cnx lang=Middle
coa lang=Cocos
cob lang=Chicomuceltec
coc lang=Cocopa
cod lang=Cocama
coe lang=Koreguaje
cof lang=Tsafiki
cog lang=Chong
coh lang=Chichonyi-Chidzihana-Chikauma
coj lang=Cochimi
cok lang=Santa
col lang=Columbia-Wenatchi
com lang=Comanche
con lang=Cofán
coo lang=Comox
cop lang=Coptic
coq lang=Coquille
cot lang=Caquinte
cou lang=Wamey
cov lang=Cao
cow lang=Cowlitz
cox lang=Nanti
coy lang=Coyaima
coz lang=Chochotec
cpa lang=Palantla
cpb lang=Ucayali-Yurúa
cpc lang=Ajyíninka
cpg lang=Cappadocian
cpi lang=Chinese
cpn lang=Cherepon
cpo lang=Kpee
cps lang=Capiznon
cpu lang=Pichis
cpx lang=Puxian
cpy lang=South
cqd lang=Chuanqiandian
cra lang=Chara
crb lang=Island
crc lang=Lonwolwol
crd lang=Coeur
crf lang=Caramanta
crg lang=Michif
crh lang=Crimean
cri lang=Sãotomense
crj lang=Southern
crk lang=Plains
crl lang=Northern
crm lang=Moose
crn lang=Cora
cro lang=Crow
crq lang=Iyo'wujwa
crr lang=Carolina
crs lang=Seychellois
crt lang=Iyojwa'ja
crv lang=Chaura
crw lang=Chrau
crx lang=Carrier
cry lang=Cori
crz lang=Cruzeño
csa lang=Chiltepec
csb lang=Kashubian
csc lang=Catalan
csd lang=Chiangmai
cse lang=Czech
csf lang=Cuban
csg lang=Chilean
csh lang=Asho
csi lang=Coast
csj lang=Songlai
csk lang=Jola-Kasa
csl lang=Chinese
csm lang=Central
csn lang=Colombian
cso lang=Sochiapam
csq lang=Croatian
csr lang=Costa
css lang=Southern
cst lang=Northern
csv lang=Sumtu
csw lang=Swampy
csy lang=Siyin
csz lang=Coos
cta lang=Tataltepec
ctc lang=Chetco-Tolowa
ctd lang=Tedim
cte lang=Tepinapa
ctg lang=Chittagonian
cth lang=Thaiphum
ctl lang=Tlacoatzintepec
ctm lang=Chitimacha
ctn lang=Chhintange
cto lang=Emberá-Catío
ctp lang=Western
cts lang=Northern
ctt lang=Wayanad
ctu lang=Chol
ctz lang=Zacatepec
cua lang=Cua
cub lang=Cubeo
cuc lang=Usila
cug lang=Cung
cuh lang=Chuka
cui lang=Cuiba
cuj lang=Mashco
cuk lang=Kuna
cul lang=Culina
cuo lang=Cumanagoto
cup lang=Cupeño
cuq lang=Cun
cur lang=Chhulung
cut lang=Teutila
cuu lang=Tai
cuv lang=Cuvok
cuw lang=Chukwa
cux lang=Tepeuxila
cuy lang=Cuitlatec
cvg lang=Chug
cvn lang=Valle
cwa lang=Kabwa
cwb lang=Maindo
cwd lang=Woods
cwe lang=Kwere
cwg lang=Chewong
cwt lang=Kuwaataay
cya lang=Nopala
cyb lang=Cayubaba
cyo lang=Cuyunon
czh lang=Huizhou
czk lang=Knaanic
czn lang=Zenzontepec
czo lang=Min
czt lang=Zotung
daa lang=Dangaléat
dac lang=Dambi
dad lang=Marik
dae lang=Duupa
dag lang=Dagbani
dah lang=Gwahatike
dai lang=Day
daj lang=Dar
dak lang=Dakota
dal lang=Dahalo
dam lang=Damakawa
dao lang=Daai
daq lang=Dandami
dar lang=Dargwa
das lang=Daho-Doo
dau lang=Dar
dav lang=Taita
daw lang=Davawenyo
dax lang=Dayi
daz lang=Dao
dba lang=Bangime
dbb lang=Deno
dbd lang=Dadiya
dbe lang=Dabe
dbf lang=Edopi
dbg lang=Dogul
dbi lang=Doka
dbj lang=Ida'an
dbl lang=Dyirbal
dbm lang=Duguri
dbn lang=Duriankere
dbo lang=Dulbu
dbp lang=Duwai
dbq lang=Daba
dbr lang=Dabarre
dbt lang=Ben
dbu lang=Bondum
dbv lang=Dungu
dbw lang=Bankan
dby lang=Dibiyaso
dcc lang=Deccani
dcr lang=Negerhollands
dda lang=Dadi
ddd lang=Dongotono
dde lang=Doondo
ddg lang=Fataluku
ddi lang=Diodio
ddj lang=Jaru
ddn lang=Dendi
ddo lang=Tsez
ddr lang=Dhudhuroa
dds lang=Donno
ddw lang=Dawera-Daweloor
dec lang=Dagik
ded lang=Dedua
dee lang=Dewoin
def lang=Dezfuli
deg lang=Degema
deh lang=Dehwari
dei lang=Demisa
dek lang=Dek
dem lang=Dem
den lang=Slavey
dep lang=Pidgin
der lang=Deori
des lang=Desano
dev lang=Domung
dez lang=Dengese
dga lang=Southern
dgb lang=Bunoge
dgc lang=Casiguran
dgd lang=Dagaari
dge lang=Degenan
dgg lang=Doga
dgh lang=Dghwede
dgi lang=Northern
dgk lang=Dagba
dgn lang=Dagoman
dgo lang=Hindi
dgr lang=Dogrib
dgs lang=Dogoso
dgt lang=Ntra'ngith
dgw lang=Daungwurrung
dgx lang=Doghoro
dgz lang=Daga
dhg lang=Dhangu
dhi lang=Dhimal
dhl lang=Dhalandji
dhm lang=Zemba
dhn lang=Dhanki
dho lang=Dhodia
dhr lang=Tharrgari
dhs lang=Dhaiso
dhu lang=Dhurga
dhv lang=Drehu
dhw lang=Danuwar
dhx lang=Dhungaloo
dia lang=Dia
dib lang=South
dic lang=Lakota
did lang=Didinga
dif lang=Dieri
dig lang=Digo
dii lang=Dimbong
dij lang=Dai
dik lang=Southwestern
dil lang=Dilling
dim lang=Dime
din lang=Dinka
dio lang=Dibo
dip lang=Northeastern
dir lang=Dirim
dis lang=Dimasa
diu lang=Gciriku
diw lang=Northwestern
dix lang=Dixon
diy lang=Diuwe
diz lang=Ding
dja lang=Djadjawurrung
djb lang=Djinba
djc lang=Dar
djd lang=Jaminjung
dje lang=Zarma
djf lang=Djangun
dji lang=Djinang
djj lang=Ndjébbana
djk lang=Aukan
djl lang=Djiwarli
djm lang=Jamsay
djn lang=Djauan
djo lang=Jangkang
djr lang=Djambarrpuyngu
dju lang=Kapriman
djw lang=Djawi
dka lang=Dakpa
dkk lang=Dakka
dkr lang=Kuijau
dks lang=Southeastern
dkx lang=Mazagway
dlg lang=Dolgan
dlk lang=Dahalik
dlm lang=Dalmatian
dln lang=Darlong
dma lang=Duma
dmb lang=Mombo
dmc lang=Gavak
dmd lang=Madhi
dme lang=Dugwor
dmf lang=Medefaidrin
dmg lang=Upper
dmk lang=Domaaki
dml lang=Dameli
dmm lang=Dama
dmo lang=Kemezung
dmr lang=East
dms lang=Dampelas
dmu lang=Dubu
dmv lang=Dumpas
dmw lang=Mudburra
dmx lang=Dema
dmy lang=Demta
dna lang=Upper
dnd lang=Daonda
dne lang=Ndendeule
dng lang=Dungan
dni lang=Lower
dnj lang=Dan
dnk lang=Dengka
dnn lang=Dzuun
dno lang=Ndrulo
dnr lang=Danaru
dnt lang=Mid
dnu lang=Danau
dnv lang=Danu
dnw lang=Western
dny lang=Dení
doa lang=Dom
dob lang=Dobu
doc lang=Northern
doe lang=Doe
dof lang=Domu
doh lang=Dong
doi lang=Dogri
dok lang=Dondo
dol lang=Doso
don lang=Doura
doo lang=Dongo
dop lang=Lukpa
doq lang=Dominican
dor lang=Dori'o
dos lang=Dogosé
dot lang=Dass
dov lang=Toka-Leya
dow lang=Doyayo
dox lang=Bussa
doy lang=Dompo
doz lang=Dorze
dpp lang=Papar
drb lang=Dair
drc lang=Minderico
drd lang=Darmiya
drg lang=Rungus
dri lang=Lela
drl lang=Baagandji
drn lang=West
dro lang=Daro-Matu
drq lang=Dura
drs lang=Gedeo
dru lang=Rukai
dry lang=Darai
dsb lang=Lower
dse lang=Dutch
dsh lang=Daasanach
dsi lang=Disa
dsl lang=Danish
dsn lang=Dusner
dso lang=Desiya
dsq lang=Tadaksahak
dta lang=Daur
dtb lang=Labuk-Kinabatangan
dtd lang=Ditidaht
dth lang=Adithinngithigh
dti lang=Ana
dtk lang=Tene
dtm lang=Tomo
dto lang=Tommo
dtp lang=Central
dtr lang=Lotud
dts lang=Toro
dtt lang=Toro
dtu lang=Tebul
dty lang=Doteli
dua lang=Duala
dub lang=Dubli
duc lang=Duna
due lang=Umiray
duf lang=Dumbea
dug lang=Chiduruma
duh lang=Dungra
dui lang=Dumun
duk lang=Uyajitaya
dul lang=Alabat
dum lang=Middle
dun lang=Dusun
duo lang=Dupaningan
dup lang=Duano
duq lang=Dusun
dur lang=Dii
dus lang=Dumi
duu lang=Drung
duv lang=Duvle
duw lang=Dusun
dux lang=Duun
duy lang=Dicamay
duz lang=Duli
dva lang=Duau
dwa lang=Diri
dwr lang=Dawro
dwu lang=Dhuwal
dww lang=Dawawa
dwy lang=Dhuwaya
dwz lang=Dewas
dya lang=Dyan
dyb lang=Dyaberdyaber
dyd lang=Dyugun
dyg lang=Villa
dyi lang=Djimini
dym lang=Yanda
dyn lang=Dyangadi
dyo lang=Jola-Fonyi
dyu lang=Dyula
dyy lang=Dyaabugay
dza lang=Tunzu
dzg lang=Dazaga
dzl lang=Dzala
dzn lang=Dzando
ebg lang=Ebughu
ebk lang=Eastern
ebr lang=Ebrié
ebu lang=Embu
ecr lang=Eteocretan
ecs lang=Ecuadorian
ecy lang=Eteocypriot
eee lang=E
efa lang=Efai
efe lang=Efe
efi lang=Efik
ega lang=Ega
egl lang=Emilian
ego lang=Eggon
egy lang=Egyptian
ehu lang=Ehueun
eip lang=Eipomek
eit lang=Eitiep
eiv lang=Askopan
eja lang=Ejamat
eka lang=Ekajuk
eke lang=Ekit
ekg lang=Ekari
eki lang=Eki
ekl lang=Kolhe
ekm lang=Elip
eko lang=Koti
ekp lang=Ekpeye
ekr lang=Yace
eky lang=Eastern
ele lang=Elepi
elh lang=El
eli lang=Nding
elk lang=Elkei
elm lang=Eleme
elo lang=El
elu lang=Elu
elx lang=Elamite
ema lang=Emai
emb lang=Embaloh
eme lang=Emerillon
emg lang=Eastern
emi lang=Mussau-Emira
emk lang=Eastern
emm lang=Mamulique
emn lang=Eman
emp lang=Northern
ems lang=Alutiiq
emu lang=Eastern
emw lang=Emplawas
emx lang=Erromintxela
emy lang=Epigraphic
ena lang=Apali
enb lang=Markweeta
enc lang=En
end lang=Ende
enf lang=Forest
enh lang=Tundra
enl lang=Enlhet
enm lang=Middle
enn lang=Engenni
eno lang=Enggano
enq lang=Enga
enr lang=Emem
enu lang=Enu
env lang=Enwan
enw lang=Enwang
enx lang=Enxet
eot lang=Eotile
epi lang=Epie
era lang=Eravallan
erg lang=Sie
erh lang=Eruwa
eri lang=Ogea
erk lang=South
ero lang=Horpa
err lang=Erre
ers lang=Ersu
ert lang=Eritai
erw lang=Erokwanas
ese lang=Ese
esh lang=Eshtehardi
esi lang=North
esk lang=Northwest
esl lang=Egyptian
esm lang=Esuma
esn lang=Salvadoran
eso lang=Estonian
esq lang=Esselen
ess lang=Central
esu lang=Yup'ik
esy lang=Eskayan
etb lang=Etebi
etc lang=Etchemin
eth lang=Ethiopian
etn lang=Eton
eto lang=Eton
etr lang=Edolo
ets lang=Yekhee
ett lang=Etruscan
etu lang=Ejagham
etx lang=Eten
etz lang=Semimi
eve lang=Even
evh lang=Uvbie
evn lang=Evenki
ewo lang=Ewondo
ext lang=Extremaduran
eya lang=Eyak
eyo lang=Keiyo
eza lang=Ezaa
eze lang=Uzekwe
faa lang=Fasu
fab lang=Annobonese
fad lang=Wagi
faf lang=Fagani
fag lang=Finongan
fah lang=Baissa
fai lang=Faiwol
faj lang=Faita
fak lang=Fang
fal lang=South
fam lang=Fam
fan lang=Fang
fap lang=Palor
far lang=Fataleka
fau lang=Fayu
fax lang=Fala
fay lang=Southwestern
faz lang=Northwestern
fbl lang=West
fcs lang=Quebec
fer lang=Feroge
ffi lang=Foia
fgr lang=Fongoro
fia lang=Nobiin
fie lang=Fyer
fip lang=Fipa
fir lang=Firan
fit lang=Meänkieli
fiw lang=Fiwaga
fkk lang=Kirya-Konzel
fkv lang=Kven
fla lang=Montana
flh lang=Foau
fli lang=Fali
fll lang=North
fln lang=Flinders
flr lang=Fuliiru
fly lang=Tsotsitaal
fmp lang=Fe'fe'
fmu lang=Far
fng lang=Fanagalo
fni lang=Fania
fod lang=Foodo
foi lang=Foi
fom lang=Foma
fon lang=Fon
for lang=Fore
fos lang=Siraya
fpe lang=Pichinglis
fqs lang=Fas
frd lang=Fordata
frm lang=Middle
fro lang=Old
frp lang=Franco-Provençal
frq lang=Forak
frr lang=North
frt lang=Fortsenal
fse lang=Finnish
fsl lang=French
fss lang=Finnish-Swedish
fud lang=East
fuj lang=Ko
fum lang=Fum
fun lang=Fulniô
fur lang=Friulian
fut lang=Futuna-Aniwa
fuu lang=Furu
fuy lang=Fuyug
fvr lang=Fur
fwa lang=Fwâi
fwe lang=Fwe
gaa lang=Ga
gab lang=Gabri
gac lang=Mixed
gad lang=Gaddang
gae lang=Warekena
gaf lang=Gende
gag lang=Gagauz
gah lang=Alekano
gai lang=Borei
gaj lang=Gadsup
gak lang=Gamkonora
gal lang=Galoli
gam lang=Kandawo
gan lang=Gan
gao lang=Gants
gap lang=Gal
gaq lang=Gata'
gar lang=Galeya
gas lang=Adiwasi
gat lang=Kenati
gau lang=Kondekor
gaw lang=Nobonob
gay lang=Gayo
gba lang=Gbaya
gbb lang=Kaytetye
gbd lang=Karadjeri
gbe lang=Niksek
gbf lang=Gaikundi
gbg lang=Gbanziri
gbh lang=Defi
gbi lang=Galela
gbj lang=Bodo
gbk lang=Gaddi
gbl lang=Gamit
gbm lang=Garhwali
gbn lang=Mo'da
gbo lang=Northern
gbp lang=Gbaya-Bossangoa
gbq lang=Gbaya-Bozoum
gbr lang=Gbagyi
gbs lang=Gbesi
gbu lang=Gagadu
gbv lang=Gbanu
gbw lang=Gabi
gbx lang=Eastern
gby lang=Gbari
gcc lang=Mali
gcd lang=Ganggalida
gce lang=Galice
gcf lang=Antillean
gcl lang=Grenadian
gcn lang=Gaina
gcr lang=Guianese
gct lang=Colonia
gdb lang=Ollari
gdc lang=Gugu
gdd lang=Gedaged
gde lang=Gude
gdf lang=Guduf-Gava
gdg lang=Ga'dang
gdh lang=Gadjerawang
gdi lang=Gundi
gdj lang=Kurtjar
gdk lang=Gadang
gdl lang=Dirasha
gdm lang=Laal
gdn lang=Umanakaina
gdo lang=Godoberi
gdq lang=Mehri
gdr lang=Wipi
gds lang=Ghandruk
gdt lang=Kungardutyi
gdu lang=Gudu
gdx lang=Godwari
gea lang=Geruma
geb lang=Kire
gec lang=Gboloo
ged lang=Gade
geg lang=Gengle
geh lang=Hutterisch
gei lang=Gebe
gej lang=Gen
gek lang=Gerka
gel lang=Fakkanci
geq lang=Geme
ges lang=Geser-Gorom
gev lang=Viya
gew lang=Gera
gex lang=Garre
gey lang=Enya
gez lang=Ge'ez
gfk lang=Patpatar
gft lang=Gafat
gga lang=Gao
ggb lang=Gbii
ggd lang=Gugadj
gge lang=Guragone
ggg lang=Gurgula
ggk lang=Kungarakany
ggl lang=Ganglau
ggn lang=Eastern
ggt lang=Gitua
ggu lang=Gban
ggw lang=Gogodala
gha lang=Ghadames
ghe lang=Southern
ghh lang=Northern
ghk lang=Geko
ghl lang=Ghulfan
ghn lang=Ghanongga
gho lang=Ghomara
ghr lang=Ghera
ghs lang=Guhu-Samane
ght lang=Kutang
gia lang=Kitja
gib lang=Gibanawa
gid lang=Gidar
gie lang=Guébie
gig lang=Goaria
gih lang=Githabul
gil lang=Gilbertese
gim lang=Gimi
gin lang=Hinukh
gio lang=Gelao
gip lang=Gimi
giq lang=Green
gir lang=Red
gis lang=North
git lang=Gitxsan
giu lang=Mulao
giw lang=White
gix lang=Gilima
giy lang=Giyug
giz lang=South
gji lang=Geji
gjk lang=Kachi
gjm lang=Gunditjmara
gjn lang=Gonja
gju lang=Gojri
gka lang=Guya
gkd lang=Magɨ
gke lang=Ndai
gkn lang=Gokana
gko lang=Kok-Nar
gkp lang=Guinea
glc lang=Bon
gld lang=Nanai
glh lang=Northwest
glj lang=Kulaal
glk lang=Gilaki
glo lang=Galambu
glr lang=Glaro-Twabo
glu lang=Gula
glw lang=Glavda
gly lang=Gule
gma lang=Gambera
gmb lang=Gula'alaa
gmd lang=Mághdì
gmg lang=Magiyi
gmh lang=Middle
gml lang=Middle
gmm lang=Gbaya-Mbodomo
gmn lang=Gimnime
gmu lang=Gumalu
gmv lang=Gamo
gmx lang=Magoma
gmy lang=Mycenaean
gmz lang=Mgbo
gna lang=Kaansa
gnb lang=Gangte
gnc lang=Guanche
gnd lang=Zulgo-Gemzek
gne lang=Ganang
gng lang=Ngangam
gnh lang=Lere
gni lang=Gooniyandi
gnj lang=Ngen
gnk lang=ǁGana
gnl lang=Gangulu
gnm lang=Ginuman
gnn lang=Gumatj
gnq lang=Gana
gnr lang=Gureng
gnt lang=Guntai
gnu lang=Gnau
gnw lang=Western
gnz lang=Ganzi
goa lang=Guro
gob lang=Playero
goc lang=Gorakor
god lang=Godié
goe lang=Gongduk
gof lang=Gofa
gog lang=Gogo
goh lang=Old
goi lang=Gobasi
goj lang=Gowlan
gol lang=Gola
gon lang=Gondi
goo lang=Gone
gop lang=Yeretuar
goq lang=Gorap
gor lang=Gorontalo
got lang=Gothic
gou lang=Gavar
gov lang=Goo
gow lang=Gorowa
gox lang=Gobu
goy lang=Goundo
goz lang=Gozarkhani
gpa lang=Gupa-Abawa
gpn lang=Taiap
gqa lang=Ga'anda
gqi lang=Guiqiong
gqn lang=Kinikinao
gqr lang=Gor
gqu lang=Qau
gra lang=Rajput
grb lang=Grebo
grc lang=Ancient
grd lang=Guruntum
grg lang=Madi
grh lang=Gbiri-Niragu
gri lang=Ghari
grj lang=Southern
grm lang=Kota
gro lang=Groma
grq lang=Gorovu
grs lang=Gresi
grt lang=Garo
gru lang=Kistane
grv lang=Central
grw lang=Gweda
grx lang=Guriaso
gry lang=Barclayville
grz lang=Guramalum
gse lang=Ghanaian
gsg lang=German
gsl lang=Gusilay
gsm lang=Guatemalan
gsn lang=Gusan
gso lang=Southwest
gsp lang=Wasembo
gss lang=Greek
gsw lang=Alemannic
gta lang=Guató
gtu lang=Aghu
gua lang=Shiki
gub lang=Guajajára
guc lang=Wayuu
gud lang=Yocoboué
gue lang=Gurindji
guf lang=Gupapuyngu
gug lang=Paraguayan
guh lang=Guahibo
gui lang=Eastern
guk lang=Gumuz
gul lang=Gullah
gum lang=Guambiano
gun lang=Mbyá
guo lang=Guayabero
gup lang=Gunwinggu
guq lang=Aché
gur lang=Farefare
gus lang=Guinean
gut lang=Maléku
guu lang=Yanomamö
guv lang=Gey
guw lang=Gun
gux lang=Gourmanchéma
guz lang=Gusii
gva lang=Kaskihá
gvc lang=Guanano
gve lang=Duwet
gvf lang=Golin
gvj lang=Guajá
gvl lang=Gulay
gvm lang=Gurmana
gvn lang=Kuku-Yalanji
gvo lang=Gavião
gvp lang=Pará
gvr lang=Western
gvs lang=Gumawana
gvy lang=Guyani
gwa lang=Mbato
gwb lang=Gwa
gwc lang=Kalami
gwd lang=Gawwada
gwe lang=Gweno
gwf lang=Gowro
gwg lang=Moo
gwi lang=Gwich'in
gwj lang=Gcwi
gwm lang=Awngthim
gwn lang=Gwandara
gwr lang=Gwere
gwt lang=Gawar-Bati
gwu lang=Guwamu
gww lang=Kwini
gwx lang=Gua
gxx lang=Wè
gya lang=Northwest
gyb lang=Garus
gyd lang=Kayardild
gye lang=Gyem
gyf lang=Gungabula
gyg lang=Gbayi
gyi lang=Gyele
gyl lang=Gayil
gym lang=Ngäbere
gyn lang=Guyanese
gyo lang=Gyalsumdo
gyr lang=Guarayu
gyy lang=Gunya
gza lang=Ganza
gzn lang=Gane
haa lang=Hän
hab lang=Hanoi
hac lang=Gurani
had lang=Hatam
haf lang=Haiphong
hag lang=Hanga
hah lang=Hahon
hai lang=Haida
haj lang=Hajong
hak lang=Hakka
hal lang=Halang
ham lang=Hewa
hao lang=Hakö
hap lang=Hupla
har lang=Harari
has lang=Haisla
hav lang=Havu
haw lang=Hawaiian
hax lang=Southern
hay lang=Haya
haz lang=Hazaragi
hba lang=Hamba
hbb lang=Huba
hbn lang=Heiban
hbu lang=Habu
hca lang=Andaman
hch lang=Huichol
hdn lang=Northern
hds lang=Honduras
hdy lang=Hadiyya
hea lang=Northern
hed lang=Herdé
heg lang=Helong
heh lang=Hehe
hei lang=Heiltsuk
hem lang=Hemba
hgm lang=Haiǁom
hgw lang=Haigwai
hhi lang=Hoia
hhr lang=Kerak
hhy lang=Hoyahoya
hia lang=Lamang
hib lang=Hibito
hid lang=Hidatsa
hif lang=Fiji
hig lang=Kamwe
hih lang=Pamosu
hii lang=Hinduri
hij lang=Hijuk
hik lang=Seit-Kaitetu
hil lang=Hiligaynon
hio lang=Tshwa
hir lang=Himarimã
hit lang=Hittite
hiw lang=Hiw
hix lang=Hixkaryana
hji lang=Haji
hka lang=Kahe
hke lang=Hunde
hkk lang=Hunjara-Kaina
hkn lang=Mel-Khaonh
hks lang=Hong
hla lang=Halia
hlb lang=Halbi
hld lang=Halang
hle lang=Hlersu
hlt lang=Nga
hma lang=Southern
hmb lang=Humburi
hmc lang=Central
hmd lang=A-Hmao
hme lang=Eastern
hmf lang=Hmong
hmg lang=Southwestern
hmh lang=Southwestern
hmi lang=Northern
hmj lang=Ge
hmk lang=Maek
hml lang=Luopohe
hmm lang=Central
hmp lang=Northern
hmq lang=Eastern
hmr lang=Hmar
hms lang=Southern
hmt lang=Hamtai
hmu lang=Hamap
hmv lang=Hmong
hmw lang=Western
hmy lang=Southern
hmz lang=Hmong
hna lang=Mina
hnd lang=Southern
hne lang=Chhattisgarhi
hnh lang=ǁAni
hni lang=Hani
hnj lang=Green
hnn lang=Hanunoo
hno lang=Northern
hns lang=Caribbean
hnu lang=Hung
hoa lang=Hoava
hob lang=Austronesian
hoc lang=Ho
hod lang=Holma
hoe lang=Horom
hoh lang=Hobyót
hoi lang=Holikachuk
hoj lang=Hadothi
hol lang=Holu
hom lang=Homa
hoo lang=Holoholo
hop lang=Hopi
hor lang=Horo
hos lang=Ho
hot lang=Hote
hov lang=Hovongan
how lang=Honi
hoy lang=Holiya
hoz lang=Hozo
hpo lang=Hpon
hps lang=Hawai'i
hra lang=Hrangkhol
hrc lang=Niwer
hre lang=Hre
hrk lang=Haruku
hrm lang=Horned
hro lang=Haroi
hrp lang=Nhirrpi
hrt lang=Hértevin
hru lang=Hruso
hrw lang=Warwar
hrx lang=Hunsrik
hrz lang=Harzani
hsb lang=Upper
hsh lang=Hungarian
hsl lang=Hausa
hsn lang=Xiang
hss lang=Harsusi
hti lang=Hoti
hto lang=Minica
hts lang=Hadza
htu lang=Hitu
hub lang=Huambisa
huc lang=ǂHoan
hud lang=Huaulu
huf lang=Humene
hug lang=Huachipaeri
huh lang=Huilliche
hui lang=Huli
huj lang=Northern
huk lang=Hulung
hul lang=Hula
hum lang=Hungana
huo lang=Hu
hup lang=Hupa
huq lang=Tsat
hur lang=Halkomelem
hus lang=Wastek
huu lang=Murui
huv lang=Huave
huw lang=Hukumina
hux lang=Nüpode
huy lang=Hulaulá
huz lang=Hunzib
hvc lang=Haitian
hvk lang=Haveke
hvn lang=Sabu
hwa lang=Wané
hwc lang=Hawaiian
hwo lang=Hwana
hya lang=Hya
iai lang=Iaai
ian lang=Iatmul
iar lang=Purari
iba lang=Iban
ibb lang=Ibibio
ibd lang=Iwaidja
ibe lang=Akpes
ibg lang=Ibanag
ibh lang=Bih
ibl lang=Ibaloi
ibm lang=Agoi
ibn lang=Ibino
ibr lang=Ibuoro
ibu lang=Ibu
iby lang=Ibani
ica lang=Ede
ich lang=Etkywan
icl lang=Icelandic
icr lang=Islander
ida lang=Idakho-Isukha-Tiriki
idb lang=Indo-Portuguese
idc lang=Idon
idd lang=Ede
ide lang=Idere
idi lang=Idi
idr lang=Indri
ids lang=Idesa
idt lang=Idaté
idu lang=Idoma
ifa lang=Amganad
ifb lang=Batad
ife lang=Ifè
iff lang=Ifo
ifk lang=Tuwali
ifm lang=Teke-Fuumu
ifu lang=Mayoyao
ify lang=Keley-I
igb lang=Ebira
ige lang=Igede
igg lang=Igana
igl lang=Igala
igm lang=Kanggape
ign lang=Ignaciano
igo lang=Isebe
igs lang=Glosa
igw lang=Igwe
ihb lang=Pidgin
ihi lang=Ihievbe
ihp lang=Iha
ijc lang=Izon
ije lang=Biseni
ijj lang=Ede
ijn lang=Kalabari
ijs lang=Southeast
ike lang=Eastern
iki lang=Iko
ikk lang=Ika
ikl lang=Ikulu
iko lang=Olulumo-Ikom
ikp lang=Ikpeshi
ikr lang=Ikaranggal
iks lang=Inuit
ikt lang=Inuvialuktun
ikv lang=Iku-Gora-Ankwa
ikw lang=Ikwere
ikx lang=Ik
ikz lang=Ikizu
ila lang=Ile
ilb lang=Ila
ilg lang=Ilgar
ili lang=Ili
ilk lang=Ilongot
ill lang=Iranun
ilo lang=Ilocano
ils lang=International
ilu lang=Ili'uun
ilv lang=Ilue
ima lang=Mala
imi lang=Anamgura
iml lang=Miluk
imn lang=Imonda
imo lang=Imbongu
imr lang=Imroing
ims lang=Marsian
imy lang=Milyan
inb lang=Inga
ing lang=Deg
inh lang=Ingush
inj lang=Jungle
inl lang=Indonesian
inm lang=Minaean
inn lang=Isinai
ino lang=Inoke-Yate
inp lang=Iñapari
ins lang=Indian
int lang=Intha
inz lang=Ineseño
ior lang=Inor
iou lang=Tuma-Irumu
iow lang=Chiwere
ipi lang=Ipili
ipo lang=Ipiko
iqu lang=Iquito
iqw lang=Ikwo
ire lang=Iresim
irh lang=Irarutu
iri lang=Rigwe
irk lang=Iraqw
irn lang=Irantxe
irr lang=Ir
iru lang=Irula
irx lang=Kamberau
iry lang=Iraya
isa lang=Isabi
isc lang=Isconahua
isd lang=Isnag
ise lang=Italian
isg lang=Irish
ish lang=Esan
isi lang=Nkem-Nkum
isk lang=Ishkashimi
ism lang=Masimasi
isn lang=Isanzu
iso lang=Isoko
isr lang=Israeli
ist lang=Istriot
isu lang=Isu
itb lang=Binongan
itd lang=Southern
ite lang=Itene
iti lang=Inlaod
itk lang=Judeo-Italian
itl lang=Itelmen
itm lang=Itu
ito lang=Itonama
itr lang=Iteri
its lang=Isekiri
itt lang=Maeng
itv lang=Itawit
itw lang=Ito
itx lang=Itik
ity lang=Moyadan
itz lang=Itzá
ium lang=Iu
ivb lang=Ibatan
ivv lang=Ivatan
iwk lang=I-Wak
iwm lang=Iwam
iwo lang=Iwur
iws lang=Sepik
ixc lang=Ixcatec
ixl lang=Ixil
iya lang=Iyayu
iyo lang=Mesaka
iyx lang=Yaa
izh lang=Ingrian
izi lang=Izi-Ezaa-Ikwo-Mgbo
izr lang=Izere
izz lang=Izi
jaa lang=Jamamadí
jab lang=Hyam
jac lang=Jakaltek
jad lang=Jahanka
jae lang=Jabem
jaf lang=Jara
jah lang=Jah
jaj lang=Zazao
jal lang=Yalahatan
jam lang=Jamaican
jan lang=Janday
jao lang=Yanyuwa
jaq lang=Yaqay
jas lang=New
jat lang=Jakati
jau lang=Yaur
jax lang=Jambi
jay lang=Yan-nhangu
jaz lang=Jawe
jbj lang=Arandai
jbk lang=Barikewa
jbn lang=Nefusa
jbo lang=Lojban
jbr lang=Jofotek-Bromnya
jbt lang=Jabutí
jbu lang=Jukun
jbw lang=Yawijibaya
jcs lang=Jamaican
jct lang=Krymchak
jda lang=Jad
jdg lang=Jadgali
jdt lang=Judeo-Tat
jeb lang=Jebero
jee lang=Jerung
jeg lang=Jeng
jeh lang=Jeh
jei lang=Yei
jek lang=Jeri
jel lang=Yelmek
jen lang=Dza
jer lang=Jere
jet lang=Manem
jeu lang=Jonkor
jgb lang=Ngbee
jgk lang=Gwak
jgo lang=Ngomba
jhi lang=Jehai
jhs lang=Jhankot
jia lang=Jina
jib lang=Jibu
jic lang=Tol
jid lang=Bu
jie lang=Jilbe
jig lang=Jingulu
jih lang=Shangzhai
jii lang=Jiiddu
jil lang=Jilim
jim lang=Jimjimen
jio lang=Jiamao
jiq lang=Khroskyabs
jit lang=Jita
jiu lang=Youle
jiv lang=Shuar
jiy lang=Buyuan
jje lang=Jeju
jjr lang=Zhár
jka lang=Kaera
jko lang=Kubo
jkr lang=Koro
jku lang=Labir
jle lang=Ngile
jls lang=Jamaican
jma lang=Dima
jmb lang=Zumbun
jmc lang=Machame
jmd lang=Yamdena
jmi lang=Jimi
jml lang=Jumli
jmn lang=Makuri
jmr lang=Kamara
jmw lang=Mouwase
jmx lang=Western
jna lang=Jangshung
jnd lang=Jandavra
jng lang=Yangman
jni lang=Janji
jnj lang=Yemsa
jnl lang=Rawat
jns lang=Jaunsari
job lang=Joba
jod lang=Wojenaka
jor lang=Jorá
jos lang=Jordanian
jow lang=Jowulu
jpr lang=Judeo-Persian
jqr lang=Jaqaru
jra lang=Jarai
jrr lang=Jiru
jru lang=Japrería
jsl lang=Japanese
jua lang=Júma
jub lang=Wannu
juc lang=Jurchen
jud lang=Worodougou
juh lang=Hone
jui lang=Ngadjuri
juk lang=Wapan
jul lang=Jirel
jum lang=Jumjum
jun lang=Juang
juo lang=Jiba
jup lang=Hupdë
jur lang=Jurúna
jus lang=Jumla
jut lang=Jutish
juu lang=Ju
juw lang=Wãpha
juy lang=Juray
jvd lang=Javindo
jvn lang=Caribbean
jwi lang=Jwira-Pepesa
jyy lang=Jaya
kaa lang=Karakalpak
kab lang=Kabyle
kac lang=Jingpho
kad lang=Kadara
kae lang=Ketangalan
kaf lang=Katso
kag lang=Kajaman
kah lang=Fer
kai lang=Karekare
kaj lang=Jju
kak lang=Kayapa
kam lang=Kamba
kao lang=Kassonke
kap lang=Bezhta
kaq lang=Capanahua
kaw lang=Old
kax lang=Kao
kay lang=Kamayurá
kba lang=Kalarko
kbb lang=Kaxuyana
kbc lang=Kadiwéu
kbd lang=Kabardian
kbe lang=Kanju
kbh lang=Camsá
kbi lang=Kaptiau
kbj lang=Kari
kbk lang=Grass
kbm lang=Iwal
kbn lang=Kare
kbo lang=Keliko
kbp lang=Kabiyé
kbq lang=Kamano
kbr lang=Kafa
kbs lang=Kande
kbt lang=Gabadi
kbu lang=Kabutra
kbv lang=Kamberataro
kbw lang=Kaiep
kbx lang=Ap
kbz lang=Duhwa
kca lang=Khanty
kcb lang=Kawacha
kcc lang=Lubila
kcd lang=Ngkâlmpw
kce lang=Kaivi
kcf lang=Ukaan
kcg lang=Tyap
kch lang=Vono
kci lang=Kamantan
kcj lang=Kobiana
kck lang=Kalanga
kcl lang=Kala
kcm lang=Tar
kcn lang=Nubi
kco lang=Kinalakna
kcp lang=Kanga
kcq lang=Kamo
kcr lang=Katla
kcs lang=Koenoem
kct lang=Kaian
kcu lang=Kikami
kcv lang=Kete
kcw lang=Kabwari
kcx lang=Kachama-Ganjule
kcy lang=Korandje
kcz lang=Konongo
kda lang=Worimi
kdc lang=Kutu
kdd lang=Yankunytjatjara
kde lang=Makonde
kdf lang=Mamusi
kdg lang=Seba
kdh lang=Tem
kdi lang=Kumam
kdj lang=Karamojong
kdk lang=Numee
kdl lang=Tsikimba
kdm lang=Kagoma
kdn lang=Kunda
kdp lang=Kaningdon-Nindem
kdq lang=Koch
kdr lang=Karaim
kdt lang=Kuy
kdu lang=Kadaru
kdv lang=Kado
kdw lang=Koneraw
kdx lang=Kam
kdy lang=Keder
kdz lang=Kwaja
kea lang=Kabuverdianu
keb lang=Kélé
kec lang=Keiga
ked lang=Kerewe
kee lang=Eastern
kef lang=Kpessi
keg lang=Tese
keh lang=Keak
kei lang=Kei
kej lang=Kadar
kek lang=Q'eqchi
kel lang=Kela-Yela
kem lang=Kemak
ken lang=Kenyang
keo lang=Kakwa
kep lang=Kaikadi
keq lang=Kamar
ker lang=Kera
kes lang=Kugbo
ket lang=Ket
keu lang=Akebu
kev lang=Kanikkaran
kew lang=Kewa
kex lang=Kukna
key lang=Kupia
kez lang=Kukele
kfa lang=Kodava
kfb lang=Kolami
kfc lang=Konda-Dora
kfd lang=Korra
kfe lang=Kota
kff lang=Koya
kfg lang=Kudiya
kfh lang=Kurichiya
kfi lang=Kannada
kfj lang=Kemiehua
kfk lang=Kinnauri
kfl lang=Kung
kfn lang=Kuk
kfo lang=Koro
kfp lang=Korwa
kfq lang=Korku
kfr lang=Kachchi
kfs lang=Bilaspuri
kft lang=Kanjari
kfu lang=Katkari
kfv lang=Kurmukar
kfw lang=Kharam
kfx lang=Kullu
kfy lang=Kumaoni
kfz lang=Koromfé
kga lang=Koyaga
kgb lang=Kawe
kgd lang=Kataang
kge lang=Komering
kgf lang=Kube
kgg lang=Kusunda
kgi lang=Selangor
kgj lang=Gamale
kgk lang=Kaiwá
kgl lang=Kunggari
kgm lang=Karipúna
kgn lang=Karingani
kgo lang=Krongo
kgp lang=Kaingang
kgq lang=Kamoro
kgr lang=Abun
kgs lang=Kumbainggar
kgt lang=Somyev
kgu lang=Kobol
kgv lang=Karas
kgw lang=Karon
kgx lang=Kamaru
kgy lang=Kyerung
kha lang=Khasi
khb lang=Lü
khc lang=Tukang
khd lang=Bädi
khe lang=Korowai
khf lang=Khuen
khh lang=Kehu
khj lang=Kuturmi
khl lang=Lusi
khn lang=Khandeshi
kho lang=Khotanese
khp lang=Kapauri
khq lang=Koyra
khr lang=Kharia
khs lang=Kasua
kht lang=Khamti
khu lang=Nkhumbi
khv lang=Khvarshi
khw lang=Khowar
khx lang=Kanu
khy lang=Ekele
khz lang=Keapara
kia lang=Kim
kib lang=Koalib
kic lang=Kickapoo
kid lang=Koshin
kie lang=Kibet
kif lang=Eastern
kig lang=Kimaama
kih lang=Kilmeri
kii lang=Kitsai
kij lang=Kilivila
kil lang=Kariya
kim lang=Tofa
kio lang=Kiowa
kip lang=Sheshi
kiq lang=Kosadle
kis lang=Kis
kit lang=Agob
kiv lang=Kimbu
kiw lang=Northeast
kix lang=Khiamniungan
kiy lang=Kirikiri
kiz lang=Kisi
kja lang=Mlap
kjb lang=Q'anjob'al
kjc lang=Coastal
kjd lang=Southern
kje lang=Kisar
kjg lang=Khmu
kjh lang=Khakas
kji lang=Zabana
kjj lang=Khinalug
kjk lang=Highland
kjl lang=Kham
kjm lang=Kháng
kjn lang=Kunjen
kjo lang=Harijan
kjp lang=Eastern
kjq lang=Western
kjr lang=Kurudu
kjs lang=East
kjt lang=Phrae
kju lang=Kashaya
kjx lang=Ramopa
kjy lang=Erave
kjz lang=Bumthangkha
kka lang=Kakanda
kkb lang=Kwerisa
kkc lang=Odoodee
kkd lang=Kinuku
kke lang=Kakabe
kkf lang=Kalaktang
kkg lang=Mabaka
kkh lang=Khün
kki lang=Kagulu
kkj lang=Kako
kkk lang=Kokota
kkl lang=Kosarek
kkm lang=Kiong
kkn lang=Kon
kko lang=Karko
kkp lang=Koko-Bera
kkq lang=Kaiku
kkr lang=Kir-Balar
kks lang=Kirfi
kkt lang=Koi
kku lang=Tumi
kkv lang=Kangean
kkw lang=Teke-Kukuya
kkx lang=Kohin
kky lang=Guugu
kkz lang=Kaska
kla lang=Klamath-Modoc
klb lang=Kiliwa
klc lang=Kolbila
kld lang=Gamilaraay
kle lang=Kulung
klf lang=Kendeje
klg lang=Tagakaulu
klh lang=Weliki
kli lang=Kalumpang
klj lang=Khalaj
klk lang=Kono
kll lang=Kagan
klm lang=Kolom
kln lang=Kalenjin
klo lang=Kapya
klp lang=Kamasa
klq lang=Rumu
klr lang=Khaling
kls lang=Kalasha
klt lang=Nukna
klu lang=Klao
klv lang=Maskelynes
klw lang=Lindu
klx lang=Koluwawa
kly lang=Kalao
klz lang=Kabola
kma lang=Konni
kmb lang=Kimbundu
kmc lang=Southern
kmd lang=Madukayang
kme lang=Bakole
kmf lang=Kare
kmg lang=Kâte
kmh lang=Kalam
kmi lang=Kami
kmj lang=Kumarbhag
kmk lang=Limos
kml lang=Tanudan
kmm lang=Kom
kmn lang=Awtuw
kmo lang=Kwoma
kmp lang=Gimme
kmq lang=Kwama
kmr lang=Northern
kms lang=Kamasau
kmt lang=Kemtuik
kmu lang=Kanite
kmv lang=Karipúna
kmw lang=Kumu
kmx lang=Waboda
kmy lang=Koma
kmz lang=Khorasani
kna lang=Kanakuru
knb lang=Lubuagan
knd lang=Konda
kne lang=Kankanaey
knf lang=Mankanya
kni lang=Kanufi
knj lang=Akatek
knk lang=Kuranko
knl lang=Keninjal
knm lang=Kanamari
kno lang=Kono
knp lang=Kwanja
knq lang=Kintaq
knr lang=Kaningra
kns lang=Kensiu
knt lang=Katukina
knu lang=Kono
knv lang=Tabo
knx lang=Kendayan
kny lang=Kanyok
knz lang=Kalamsé
koa lang=Konomala
koc lang=Kpati
kod lang=Kodi
koe lang=Kacipo-Balesi
kof lang=Kubi
kog lang=Cogui
koh lang=Koyo
koi lang=Komi-Permyak
kok lang=Konkani
kol lang=Kol
koo lang=Konzo
kop lang=Waube
koq lang=Kota
kos lang=Kosraean
kot lang=Lagwan
kou lang=Koke
kov lang=Kudu-Camo
kow lang=Kugama
koy lang=Koyukon
koz lang=Korak
kpa lang=Kutto
kpb lang=Mullu
kpc lang=Curripaco
kpd lang=Koba
kpe lang=Kpelle
kpf lang=Komba
kpg lang=Kapingamarangi
kph lang=Kplang
kpi lang=Kofei
kpj lang=Karajá
kpk lang=Kpan
kpl lang=Kpala
kpm lang=Koho
kpn lang=Kepkiriwát
kpo lang=Ikposo
kpp lang=Paku
kpq lang=Korupun-Sela
kpr lang=Korafe-Yegha
kps lang=Tehit
kpt lang=Karata
kpu lang=Kafoa
kpv lang=Komi-Zyrian
kpw lang=Kobon
kpx lang=Mountain
kpy lang=Koryak
kpz lang=Kupsabiny
kqa lang=Mum
kqb lang=Kovai
kqc lang=Doromu-Koki
kqd lang=Koy
kqe lang=Kalagan
kqf lang=Kakabai
kqg lang=Khe
kqh lang=Kisankasa
kqi lang=Koitabu
kqj lang=Koromira
kqk lang=Kotafon
kql lang=Kyenele
kqm lang=Khisa
kqn lang=Kaonde
kqo lang=Eastern
kqp lang=Kimré
kqq lang=Krenak
kqr lang=Kimaragang
kqs lang=Northern
kqt lang=Klias
kqu lang=Seroa
kqv lang=Okolod
kqw lang=Kandas
kqx lang=Mser
kqy lang=Koorete
kqz lang=Korana
kra lang=Kumhali
krb lang=Karkin
krc lang=Karachay-Balkar
krd lang=Kairui-Midiki
kre lang=Panará
krf lang=Koro
krh lang=Kurama
kri lang=Krio
krj lang=Kinaray-a
krk lang=Kerek
krl lang=Karelian
krm lang=Krim
krn lang=Sapo
krp lang=Korop
krr lang=Kru'ng
krs lang=Kresh
kru lang=Kurukh
krv lang=Kavet
krw lang=Western
krx lang=Karon
kry lang=Kryts
krz lang=Sota
ksa lang=Shuwa-Zamani
ksb lang=Shambala
ksc lang=Southern
ksd lang=Tolai
kse lang=Kuni
ksf lang=Bafia
ksg lang=Kusaghe
ksi lang=Krisa
ksj lang=Uare
ksk lang=Kansa
ksl lang=Kumalu
ksm lang=Kumba
ksn lang=Kasiguranin
kso lang=Kofa
ksp lang=Kaba
ksq lang=Kwaami
ksr lang=Borong
kss lang=Southern
kst lang=Winyé
ksu lang=Khamyang
ksv lang=Kusu
ksw lang=S'gaw
ksx lang=Kedang
ksy lang=Kharia
ksz lang=Kodaku
kta lang=Katua
ktb lang=Kambaata
ktc lang=Kholok
ktd lang=Kokata
ktf lang=Kwami
ktg lang=Kalkatungu
kth lang=Karanga
kti lang=North
ktj lang=Plapo
ktk lang=Kaniet
ktl lang=Koroshi
ktm lang=Kurti
ktn lang=Karitiâna
kto lang=Kuot
ktp lang=Kaduo
ktq lang=Katabaga
ktr lang=Kota
kts lang=South
ktt lang=Ketum
ktu lang=Kituba
ktv lang=Eastern
ktw lang=Kato
ktx lang=Kaxararí
kty lang=Kango
ktz lang=Juǀ'hoan
kub lang=Kutep
kuc lang=Kwinsu
kud lang=Auhelawa
kue lang=Kuman
kuf lang=Western
kug lang=Kupa
kuh lang=Kushi
kui lang=Kuikúro
kuj lang=Kuria
kuk lang=Kepo'
kul lang=Kulere
kum lang=Kumyk
kun lang=Kunama
kuo lang=Kumukio
kup lang=Kunimaipa
kuq lang=Karipuna
kus lang=Kusaal
kut lang=Kutenai
kuu lang=Upper
kuv lang=Kur
kuw lang=Kpagua
kux lang=Kukatja
kuy lang=Kuuku-Ya'u
kuz lang=Kunza
kva lang=Bagvalal
kvb lang=Kubu
kvc lang=Kove
kvd lang=Kui
kve lang=Kalabakan
kvf lang=Kabalai
kvg lang=Kuni-Boazi
kvh lang=Komodo
kvi lang=Kwang
kvj lang=Psikye
kvk lang=Korean
kvl lang=Brek
kvm lang=Kendem
kvn lang=Border
kvo lang=Dobel
kvp lang=Kompane
kvq lang=Geba
kvr lang=Kerinci
kvt lang=Lahta
kvu lang=Yinbaw
kvv lang=Kola
kvw lang=Wersing
kvx lang=Parkari
kvy lang=Yintale
kvz lang=Tsakwambo
kwa lang=Dâw
kwb lang=Baa
kwc lang=Likwala
kwd lang=Kwaio
kwe lang=Kwerba
kwf lang=Kwara'ae
kwg lang=Sara
kwh lang=Kowiai
kwi lang=Awa-Cuaiquer
kwj lang=Kwanga
kwk lang=Kwak'wala
kwl lang=Kofyar
kwm lang=Kwambi
kwn lang=Kwangali
kwo lang=Kwomtari
kwp lang=Kodia
kwq lang=Kwak
kwr lang=Kwer
kws lang=Kwese
kwt lang=Kwesten
kwu lang=Kwakum
kwv lang=Sara
kww lang=Kwinti
kwx lang=Khirwar
kwz lang=Kwadi
kxa lang=Kairiru
kxb lang=Krobu
kxc lang=Khonso
kxd lang=Brunei
kxe lang=Kakihum
kxf lang=Manumanaw
kxh lang=Karo
kxi lang=Keningau
kxj lang=Kulfa
kxk lang=Zayein
kxl lang=Nepali
kxm lang=Northern
kxn lang=Kanowit
kxo lang=Kanoé
kxp lang=Wadiyara
kxq lang=Smärky
kxr lang=Koro
kxs lang=Kangjia
kxt lang=Koiwat
kxu lang=Kui
kxv lang=Kuvi
kxw lang=Konai
kxx lang=Likuba
kxy lang=Kayong
kxz lang=Kerewo
kya lang=Kwaya
kyb lang=Butbut
kyc lang=Kyaka
kyd lang=Karey
kye lang=Krache
kyf lang=Kouya
kyg lang=Keyagana
kyh lang=Karok
kyi lang=Kiput
kyj lang=Karao
kyk lang=Kamayo
kyl lang=Kalapuya
kym lang=Kpatili
kyn lang=Karolanos
kyo lang=Kelon
kyp lang=Kang
kyq lang=Kenga
kyr lang=Kuruáya
kys lang=Baram
kyt lang=Kayagar
kyu lang=Western
kyv lang=Kayort
kyw lang=Kudmali
kyx lang=Rapoisi
kyy lang=Kambaira
kyz lang=Kayabí
kza lang=Western
kzb lang=Kaibobo
kzc lang=Bondoukou
kzd lang=Kadai
kze lang=Kosena
kzf lang=Da'a
kzg lang=Kikai
kzh lang=Dongolawi
kzi lang=Kelabit
kzj lang=Coastal
kzk lang=Kazukuru
kzl lang=Kayeli
kzm lang=Kais
kzn lang=Kokola
kzo lang=Kaningi
kzp lang=Kaidipang
kzq lang=Kaike
kzr lang=Karang
kzs lang=Sugut
kzt lang=Tambunan
kzu lang=Kayupulau
kzv lang=Komyandaret
kzw lang=Kariri
kzx lang=Kamarian
kzy lang=Kango-Sua
kzz lang=Kalabra
laa lang=Lapuyan
lab lang=Linear
lac lang=Lacandon
lad lang=Ladino
lae lang=Pattani
laf lang=Lafofa
lag lang=Langi
lah lang=Lahnda
lai lang=Lambya
laj lang=Lango
lak lang=Laka
lam lang=Lamba
lan lang=Laru
lap lang=Kabba-Laka
laq lang=Qabiao
lar lang=Larteh
las lang=Gur
lau lang=Laba
law lang=Lauje
lax lang=Tiwa
lay lang=Lama
laz lang=Aribwatsa
lbb lang=Label
lbc lang=Lakkia
lbe lang=Lak
lbf lang=Tinani
lbg lang=Laopang
lbi lang=La'bi
lbj lang=Ladakhi
lbk lang=Central
lbl lang=Libon
lbm lang=Lodhi
lbn lang=Lamet
lbo lang=Laven
lbq lang=Wampar
lbr lang=Northern
lbs lang=Libyan
lbt lang=Lachi
lbu lang=Labu
lbv lang=Lavatbura-Lamusong
lbw lang=Tolaki
lbx lang=Lawangan
lby lang=Lamu-Lamu
lbz lang=Lardil
lcc lang=Legenyem
lcd lang=Lola
lce lang=Loncong
lcf lang=Lubu
lch lang=Luchazi
lcl lang=Lisela
lcm lang=Tungag
lcp lang=Western
lcq lang=Luhu
lcs lang=Lisabata-Nuniali
lda lang=Kla
ldb lang=Idun
ldd lang=Luri
ldg lang=Lenyima
ldh lang=Lamja-Dengsa-Tola
ldj lang=Lemoro
ldk lang=Leelau
ldl lang=Kaan
ldm lang=Landoma
ldn lang=Láadan
ldo lang=Loo
ldp lang=Tso
ldq lang=Lufu
lea lang=Lega-Shabunda
leb lang=Lala-Bisa
lec lang=Leco
led lang=Lendu
lee lang=Lyélé
lef lang=Lelemi
leh lang=Lenje
lei lang=Lemio
lej lang=Lengola
lek lang=Leipon
lel lang=Lele
lem lang=Nomaande
len lang=Honduran
leo lang=Leti
lep lang=Lepcha
leq lang=Lembena
ler lang=Lenkau
les lang=Lese
let lang=Lesing-Gelimi
leu lang=Kara
lev lang=Lamma
lew lang=Ledo
lex lang=Luang
ley lang=Lemolang
lez lang=Lezgi
lfa lang=Lefa
lfn lang=Lingua
lga lang=Lungga
lgb lang=Laghu
lgg lang=Lugbara
lgh lang=Laghuu
lgi lang=Lengilu
lgk lang=Neverver
lgl lang=Wala
lgm lang=Lega-Mwenga
lgn lang=Opuuo
lgq lang=Logba
lgr lang=Lengo
lgt lang=Pahi
lgu lang=Longgu
lgz lang=Ligenza
lha lang=Laha
lhh lang=Laha
lhi lang=Lahu
lhl lang=Lahul
lhn lang=Lahanan
lhp lang=Lhokpu
lhs lang=Mlahsö
lht lang=Lo-Toga
lhu lang=Lahu
lia lang=West-Central
lib lang=Likum
lic lang=Hlai
lid lang=Nyindrou
lie lang=Likila
lif lang=Limbu
lig lang=Ligbi
lih lang=Lihir
lii lang=Lingkhim
lij lang=Ligurian
lik lang=Lika
lil lang=Lillooet
lio lang=Liki
lip lang=Sekpele
liq lang=Libido
lir lang=Liberian
lis lang=Lisu
liu lang=Logorik
liv lang=Livonian
liw lang=Col
lix lang=Liabuku
liy lang=Banda-Bambari
liz lang=Libinza
lja lang=Golpa
lje lang=Rampi
lji lang=Laiyolo
ljl lang=Li'o
ljp lang=Lampung
ljw lang=Yirandali
ljx lang=Yuru
lka lang=Lakalei
lkb lang=Kabras
lkc lang=Kucong
lkd lang=Lakondê
lke lang=Kenyi
lkh lang=Lakha
lki lang=Laki
lkj lang=Remun
lkl lang=Laeko-Libuat
lkm lang=Kalaamaya
lkn lang=Lakon
lko lang=Khayo
lkr lang=Päri
lks lang=Kisa
lkt lang=Lakota
lku lang=Kungkari
lky lang=Lokoya
lla lang=Lala-Roba
llb lang=Lolo
llc lang=Lele
lld lang=Ladin
lle lang=Lele
llf lang=Hermit
llg lang=Lole
llh lang=Lamu
lli lang=Teke-Laali
llj lang=Ladji-Ladji
llk lang=Lelak
lll lang=Lilau
llm lang=Lasalimu
lln lang=Lele
llo lang=Khlor
llp lang=North
llq lang=Lolak
lls lang=Lithuanian
llu lang=Lau
llx lang=Lauan
lma lang=East
lmb lang=Merei
lmc lang=Limilngan
lmd lang=Lumun
lme lang=Pévé
lmf lang=South
lmg lang=Lamogai
lmh lang=Lambichhong
lmi lang=Lombi
lmj lang=West
lmk lang=Lamkang
lml lang=Raga
lmn lang=Lambadi
lmo lang=Lombard
lmp lang=Limbum
lmq lang=Lamatuka
lmr lang=Lamalera
lmu lang=Lamenu
lmv lang=Lomaiviti
lmw lang=Lake
lmx lang=Laimbue
lmy lang=Laboya
lmz lang=Lumbee
lna lang=Langbashe
lnb lang=Mbalanhu
lnd lang=Lun
lnh lang=Lanoh
lni lang=Daantanai'
lnj lang=Linngithigh
lnl lang=South
lnm lang=Langam
lnn lang=Lorediakarkar
lno lang=Lango
lns lang=Lamnso'
lnu lang=Longuda
lnw lang=Lanima
loa lang=Loloda
lob lang=Lobi
loc lang=Inonhan
lod lang=Berawan
loe lang=Saluan
lof lang=Logol
log lang=Logo
loh lang=Narim
loi lang=Lomakka
loj lang=Lou
lok lang=Loko
lol lang=Mongo
lom lang=Looma
lon lang=Malawi
loo lang=Lombo
lop lang=Lopa
loq lang=Lobala
lor lang=Téén
los lang=Loniu
lot lang=Lotuko
lou lang=Louisiana
lov lang=Lopi
low lang=Tampias
lox lang=Loun
loz lang=Lozi
lpa lang=Lelepa
lpe lang=Lepki
lpn lang=Long
lpo lang=Lipo
lpx lang=Lopit
lra lang=Rara
lrc lang=Northern
lre lang=Laurentian
lrg lang=Laragia
lri lang=Marachi
lrk lang=Loarki
lrl lang=Lari
lrm lang=Marama
lrn lang=Lorang
lro lang=Laro
lrr lang=Southern
lrt lang=Larantuka
lrv lang=Larevat
lrz lang=Lemerig
lsa lang=Lasgerdi
lsd lang=Lishana
lse lang=Lusengo
lsh lang=Lish
lsi lang=Lashi
lsl lang=Latvian
lsm lang=Saamia
lso lang=Laos
lsp lang=Panamanian
lsr lang=Aruop
lss lang=Lasi
lst lang=Trinidad
lsy lang=Mauritian
ltc lang=Middle
ltg lang=Latgalian
lti lang=Leti
ltn lang=Latundê
lto lang=Olutsotso
lts lang=Lutachoni
ltu lang=Latu
lua lang=Luba-Kasai
luc lang=Aringa
lud lang=Ludian
lue lang=Luvale
luf lang=Laua
lui lang=Luiseño
luj lang=Luna
luk lang=Lunanakha
lul lang=Olu'bo
lum lang=Luimbi
lun lang=Lunda
luo lang=Luo
lup lang=Lumbu
luq lang=Lucumi
lur lang=Laura
lus lang=Mizo
lut lang=Lushootseed
luu lang=Lumba-Yakkha
luv lang=Luwati
luy lang=Luhya
luz lang=Southern
lva lang=Maku'a
lvi lang=Lawi
lvk lang=Lavukaleve
lvu lang=Levuka
lwa lang=Lwalu
lwe lang=Lewo
lwg lang=Wanga
lwh lang=White
lwl lang=Eastern
lwm lang=Laomian
lwo lang=Luwo
lws lang=Malawian
lwt lang=Lewotobi
lwu lang=Lawu
lww lang=Lewo
lya lang=Layakha
lyg lang=Lyngngam
lyn lang=Luyana
lzh lang=Literary
lzl lang=Litzlitz
lzn lang=Leinong
lzz lang=Laz
maa lang=San
mab lang=Yutanduchi
mad lang=Madurese
mae lang=Bo-Rukul
maf lang=Mafa
mag lang=Magahi
mai lang=Maithili
maj lang=Jalapa
mak lang=Makasar
mam lang=Mam
man lang=Mandingo
maq lang=Chiquihuitlán
mas lang=Maasai
mat lang=Matlatzinca
mau lang=Huautla
mav lang=Sateré-Mawé
maw lang=Mampruli
max lang=North
maz lang=Central
mba lang=Higaonon
mbb lang=Western
mbc lang=Macushi
mbd lang=Dibabawon
mbe lang=Molale
mbf lang=Baba
mbh lang=Mangseng
mbi lang=Ilianen
mbj lang=Nadëb
mbk lang=Malol
mbl lang=Maxakalí
mbm lang=Ombamba
mbn lang=Macaguán
mbo lang=Mbo
mbp lang=Wiwa
mbq lang=Maisin
mbr lang=Nukak
mbs lang=Sarangani
mbt lang=Matigsalug
mbu lang=Mbula-Bwazza
mbv lang=Mbulungish
mbw lang=Maring
mbx lang=Sepik
mby lang=Memoni
mbz lang=Amoltepec
mca lang=Maca
mcb lang=Machiguenga
mcc lang=Bitur
mcd lang=Sharanahua
mce lang=Itundujia
mcf lang=Matsés
mcg lang=Mapoyo
mch lang=Maquiritari
mci lang=Mese
mcj lang=Mvanip
mck lang=Mbunda
mcl lang=Macaguaje
mcm lang=Kristang
mcn lang=Masana
mco lang=Coatlán
mcp lang=Makaa
mcq lang=Ese
mcr lang=Menya
mcs lang=Mambai
mcu lang=Cameroon
mcv lang=Minanibai
mcw lang=Mawa
mcx lang=Mpiemo
mcy lang=South
mcz lang=Mawan
mda lang=Mada
mdb lang=Morigi
mdc lang=Male
mdd lang=Mbum
mde lang=Bura
mdf lang=Moksha
mdg lang=Massalat
mdh lang=Maguindanao
mdi lang=Mamvu
mdj lang=Mangbetu
mdk lang=Mangbutu
mdl lang=Maltese
mdm lang=Mayogo
mdn lang=Mbati
mdp lang=Mbala
mdq lang=Mbole
mdr lang=Mandar
mds lang=Maria
mdt lang=Mbere
mdu lang=Mboko
mdv lang=Santa
mdw lang=Mbosi
mdx lang=Dizin
mdy lang=Maale
mdz lang=Suruí
mea lang=Menka
meb lang=Ikobi-Mena
mec lang=Mara
med lang=Melpa
mee lang=Mengen
mef lang=Megam
meg lang=Mea
meh lang=Southwestern
mei lang=Midob
mej lang=Meyah
mek lang=Mekeo
mel lang=Central
mem lang=Mangala
men lang=Mende
meo lang=Kedah
mep lang=Miriwung
meq lang=Merey
mer lang=Meru
mes lang=Masmaje
met lang=Mato
meu lang=Motu
mev lang=Mano
mew lang=Maaka
mey lang=Hassaniya
mez lang=Menominee
mfa lang=Pattani
mfb lang=Bangka
mfc lang=Mba
mfd lang=Mendankwe-Nkwen
mfe lang=Mauritian
mff lang=Naki
mfg lang=Mixifore
mfh lang=Matal
mfi lang=Wandala
mfj lang=Mefele
mfk lang=North
mfl lang=Putai
mfm lang=Marghi
mfn lang=Cross
mfo lang=Mbe
mfp lang=Makassar
mfq lang=Moba
mfr lang=Marrithiyel
mfs lang=Mexican
mft lang=Mokerang
mfu lang=Mbwela
mfv lang=Mandjak
mfw lang=Mulaha
mfx lang=Melo
mfy lang=Mayo
mfz lang=Mabaan
mga lang=Middle
mgb lang=Mararit
mgc lang=Morokodo
mgd lang=Moru
mge lang=Mango
mgf lang=Maklew
mgg lang=Mpongmpong
mgh lang=Makhuwa-Meetto
mgi lang=Jili
mgj lang=Abureni
mgk lang=Mawes
mgl lang=Maleu-Kilenge
mgm lang=Mambae
mgn lang=Mbangi
mgo lang=Meta'
mgp lang=Eastern
mgq lang=Malila
mgr lang=Mambwe-Lungu
mgs lang=Manda
mgt lang=Mongol
mgu lang=Mailu
mgv lang=Matengo
mgw lang=Matumbi
mgy lang=Mbunga
mgz lang=Mbugwe
mha lang=Manda
mhb lang=Mahongwe
mhc lang=Mocho
mhd lang=Mbugu
mhe lang=Besisi
mhf lang=Mamaa
mhg lang=Margu
mhi lang=Ma'di
mhj lang=Mogholi
mhk lang=Mungaka
mhl lang=Mauwake
mhm lang=Makhuwa-Moniga
mhn lang=Mòcheno
mho lang=Mashi
mhp lang=Balinese
mhq lang=Mandan
mhs lang=Buru
mht lang=Mandahuaca
mhu lang=Taraon
mhw lang=Mbukushu
mhx lang=Lhao
mhy lang=Ma'anyan
mhz lang=Mor
mia lang=Miami
mib lang=Atatláhuca
mic lang=Mi'kmaq
mid lang=Mandaic
mie lang=Ocotepec
mif lang=Mofu-Gudur
mig lang=San
mih lang=Chayuco
mii lang=Chigmecatitlán
mij lang=Mungbam
mik lang=Mikasuki
mil lang=Peñoles
mim lang=Alacatlatzala
min lang=Minangkabau
mio lang=Pinotepa
mip lang=Apasco-Apoala
miq lang=Miskito
mir lang=Isthmus
mit lang=Southern
miu lang=Cacaloxtepec
miw lang=Akoye
mix lang=Mixtepec
miy lang=Ayutla
miz lang=Coatzospan
mjb lang=Makalero
mjc lang=San
mjd lang=Northwest
mje lang=Muskum
mji lang=Kim
mjj lang=Mawak
mjk lang=Matukar
mjl lang=Mandeali
mjm lang=Medebur
mjn lang=Mebu
mjo lang=Malankuravan
mjp lang=Malapandaram
mjq lang=Malaryan
mjr lang=Malavedan
mjs lang=Miship
mjt lang=Sawriya
mju lang=Manna-Dora
mjv lang=Mannan
mjw lang=Karbi
mjx lang=Mahali
mjy lang=Mahican
mjz lang=Majhi
mka lang=Mbre
mkb lang=Mal
mkc lang=Siliput
mke lang=Mawchi
mkf lang=Miya
mkg lang=Mak
mki lang=Dhatki
mkj lang=Mokilese
mkk lang=Byep
mkl lang=Mokole
mkm lang=Moklen
mkn lang=Kupang
mko lang=Mingang
mkp lang=Moikodi
mkq lang=Bay
mkr lang=Malas
mks lang=Silacayoapan
mkt lang=Vamale
mku lang=Konyanka
mkv lang=Mafea
mkx lang=Cinamiguin
mky lang=East
mkz lang=Makasae
mla lang=Tamambo
mlb lang=Mbule
mlc lang=Caolan
mle lang=Manambu
mlf lang=Mal
mlh lang=Mape
mli lang=Malimpung
mlj lang=Miltu
mlk lang=Ilwana
mll lang=Malua
mlm lang=Mulam
mln lang=Malango
mlo lang=Mlomp
mlp lang=Bargam
mlq lang=Western
mlr lang=Vame
mls lang=Masalit
mlu lang=To'abaita
mlv lang=Mwotlap
mlw lang=Moloko
mlx lang=Malfaxal
mlz lang=Malaynon
mma lang=Mama
mmb lang=Momina
mmc lang=Michoacán
mmd lang=Maonan
mme lang=Mae
mmf lang=Mundat
mmg lang=North
mmh lang=Mehináku
mmi lang=Musar
mmj lang=Majhwar
mmk lang=Mukha-Dora
mml lang=Man
mmm lang=Maii
mmn lang=Mamanwa
mmo lang=Mangga
mmp lang=Musan
mmq lang=Aisi
mmr lang=Western
mmt lang=Malalamai
mmu lang=Mmaala
mmv lang=Miriti
mmw lang=Emae
mmx lang=Madak
mmy lang=Migaama
mmz lang=Mabaale
mna lang=Mbula
mnb lang=Muna
mnc lang=Manchu
mnd lang=Mondé
mne lang=Naba
mnf lang=Mundani
mng lang=Eastern
mnh lang=Mono
mni lang=Manipuri
mnj lang=Munji
mnk lang=Mandinka
mnl lang=Tiale
mnm lang=Mapena
mnn lang=Southern
mnp lang=Min
mnq lang=Minriq
mnr lang=Mono
mns lang=Mansi
mnt lang=Maykulan
mnu lang=Mer
mnv lang=Rennellese
mnw lang=Mon
mnx lang=Manikion
mny lang=Manyawa
mnz lang=Moni
moa lang=Mwan
moc lang=Mocoví
mod lang=Mobilian
moe lang=Montagnais
mog lang=Mongondow
moh lang=Mohawk
moi lang=Mboi
moj lang=Monzombo
mok lang=Morori
mom lang=Monimbo
moo lang=Monom
mop lang=Mopan
moq lang=Mor
mor lang=Moro
mos lang=Moore
mot lang=Barí
mou lang=Mogum
mov lang=Mojave
mow lang=Moi
mox lang=Molima
moy lang=Shekkacho
moz lang=Mukulu
mpa lang=Mpoto
mpb lang=Mullukmulluk
mpc lang=Mangarayi
mpd lang=Machinere
mpe lang=Majang
mpg lang=Marba
mph lang=Maung
mpi lang=Mpade
mpj lang=Martu
mpk lang=Mbara
mpl lang=Middle
mpm lang=Yosondúa
mpn lang=Mindiri
mpo lang=Miu
mpp lang=Migabac
mpq lang=Matís
mpr lang=Vangunu
mps lang=Dadibi
mpt lang=Mian
mpu lang=Makuráp
mpv lang=Mungkip
mpw lang=Mapidian
mpx lang=Misima-Paneati
mpy lang=Mapia
mpz lang=Mpi
mqa lang=Maba
mqb lang=Mbuko
mqc lang=Mangole
mqe lang=Matepi
mqf lang=Momuna
mqg lang=Kota
mqh lang=Tlazoyaltepec
mqi lang=Mariri
mqj lang=Mamasa
mqk lang=Rajah
mql lang=Mbelime
mqm lang=South
mqn lang=Moronene
mqo lang=Modole
mqp lang=Manipa
mqq lang=Minokok
mqr lang=Mander
mqs lang=West
mqt lang=Mok
mqu lang=Mandari
mqv lang=Mosimo
mqw lang=Murupi
mqx lang=Mamuju
mqy lang=Manggarai
mqz lang=Malasanga
mra lang=Mlabri
mrb lang=Marino
mrc lang=Maricopa
mrd lang=Western
mre lang=Martha's
mrf lang=Elseng
mrg lang=Mising
mrh lang=Mara
mrj lang=Western
mrk lang=Hmwaveke
mrl lang=Mortlockese
mrm lang=Merlav
mrn lang=Cheke
mro lang=Mru
mrp lang=Morouas
mrq lang=North
mrr lang=Hill
mrs lang=Maragus
mrt lang=Margi
mru lang=Mono
mrv lang=Mangarevan
mrw lang=Maranao
mrx lang=Dineor
mry lang=Karaga
mrz lang=Marind
msb lang=Masbatenyo
msc lang=Sankaran
msd lang=Yucatec
mse lang=Musey
msf lang=Mekwei
msg lang=Moraid
msi lang=Sabah
msj lang=Ma
msk lang=Mansaka
msl lang=Molof
msm lang=Agusan
msn lang=Vurës
mso lang=Mombum
msp lang=Maritsauá
msq lang=Caac
msr lang=Mongolian
mss lang=West
msu lang=Musom
msv lang=Maslam
msw lang=Mansoanka
msx lang=Moresada
msy lang=Aruamu
msz lang=Momare
mta lang=Cotabato
mtb lang=Anyin
mtc lang=Munit
mtd lang=Mualang
mte lang=Alu
mtf lang=Murik
mtg lang=Una
mth lang=Munggui
mti lang=Maiwa
mtj lang=Moskona
mtk lang=Mbe'
mtl lang=Montol
mtm lang=Mator
mtn lang=Matagalpa
mto lang=Totontepec
mtp lang=Wichí
mtq lang=Muong
mtr lang=Mewari
mts lang=Yora
mtt lang=Mota
mtu lang=Tututepec
mtv lang=Asaro'o
mtw lang=Magahat
mtx lang=Tidaá
mty lang=Nabi
mua lang=Mundang
mub lang=Mubi
muc lang=Mbu'
mud lang=Mednyj
mue lang=Media
mug lang=Musgu
muh lang=Mündü
mui lang=Musi
muj lang=Mabire
mul lang=Translingual
mum lang=Maiwala
muo lang=Nyong
mup lang=Malvi
muq lang=Eastern
mur lang=Murle
mus lang=Creek
mut lang=Western
muu lang=Yaaku
muv lang=Muthuvan
mux lang=Bo-Ung
muy lang=Muyang
muz lang=Mursi
mva lang=Manam
mvb lang=Mattole
mvd lang=Mamboru
mvg lang=Yucuañe
mvh lang=Mire
mvi lang=Miyako
mvk lang=Mekmek
mvl lang=Mbara
mvm lang=Muya
mvn lang=Minaveha
mvo lang=Marovo
mvp lang=Duri
mvq lang=Moere
mvr lang=Marau
mvs lang=Massep
mvt lang=Mpotovoro
mvu lang=Marfa
mvv lang=Tagal
mvw lang=Machinga
mvx lang=Meoswar
mvy lang=Indus
mvz lang=Mesqan
mwa lang=Mwatebu
mwb lang=Juwal
mwc lang=Are
mwe lang=Mwera
mwf lang=Murrinh-Patha
mwg lang=Aiklep
mwh lang=Mouk-Aria
mwi lang=Labo
mwk lang=Kita
mwl lang=Mirandese
mwm lang=Sar
mwn lang=Nyamwanga
mwo lang=Central
mwp lang=Kala
mwq lang=Mün
mwr lang=Marwari
mws lang=Mwimbi-Muthambi
mwt lang=Moken
mwu lang=Mittu
mwv lang=Mentawai
mww lang=White
mwz lang=Moingi
mxa lang=Northwest
mxb lang=Tezoatlán
mxd lang=Modang
mxe lang=Mele-Fila
mxf lang=Malgbe
mxg lang=Mbangala
mxh lang=Mvuba
mxi lang=Mozarabic
mxj lang=Miju
mxk lang=Monumbo
mxl lang=Maxi
mxm lang=Meramera
mxn lang=Moi
mxo lang=Mbowe
mxp lang=Tlahuitoltepec
mxq lang=Juquila
mxr lang=Murik
mxs lang=Huitepec
mxt lang=Jamiltepec
mxu lang=Mada
mxv lang=Metlatónoc
mxw lang=Namo
mxx lang=Mahou
mxy lang=Southeastern
mxz lang=Central
myb lang=Mbay
myc lang=Mayeka
mye lang=Myene
myf lang=Bambassi
myg lang=Manta
myh lang=Makah
myj lang=Mangayat
myk lang=Mamara
myl lang=Moma
mym lang=Me'en
myo lang=Anfillo
myp lang=Pirahã
myr lang=Muniche
mys lang=Mesmes
myu lang=Mundurukú
myv lang=Erzya
myw lang=Muyuw
myx lang=Masaba
myy lang=Macuna
myz lang=Classical
mza lang=Santa
mzb lang=Northern
mzc lang=Madagascar
mzd lang=Malimba
mze lang=Morawa
mzg lang=Monastic
mzh lang=Wichí
mzi lang=Ixcatlán
mzj lang=Manya
mzk lang=Nigeria
mzl lang=Mazatlán
mzm lang=Mumuye
mzn lang=Mazanderani
mzo lang=Matipuhy
mzp lang=Movima
mzq lang=Mori
mzr lang=Marúbo
mzs lang=Macanese
mzt lang=Mintil
mzu lang=Inapang
mzv lang=Manza
mzw lang=Deg
mzx lang=Mawayana
mzy lang=Mozambican
mzz lang=Maiadomu
naa lang=Namla
nab lang=Nambikwara
nac lang=Narak
nae lang=Naka'ela
naf lang=Nabak
nag lang=Naga
nah lang=Nahuatl
naj lang=Nalu
nak lang=Nakanai
nal lang=Nalik
nam lang=Ngan'gityemerri
nan lang=Min
nao lang=Naaba
nap lang=Neapolitan
naq lang=Khoekhoe
nar lang=Iguta
nas lang=Nasioi
nat lang=Hungworo
naw lang=Nawuri
nax lang=Nakwi
nay lang=Ngarrindjeri
naz lang=Coatepec
nba lang=Nyemba
nbb lang=Ndoe
nbc lang=Chang
nbd lang=Ngbinda
nbe lang=Konyak
nbg lang=Nagarchal
nbh lang=Ngamo
nbi lang=Mao
nbj lang=Ngarinman
nbk lang=Nake
nbm lang=Ngbaka
nbn lang=Kuri
nbo lang=Nkukoli
nbp lang=Nnam
nbq lang=Nggem
nbr lang=Numana
nbs lang=Namibian
nbt lang=Na
nbu lang=Rongmei
nbv lang=Ngamambo
nbw lang=Southern
nby lang=Ningera
nca lang=Iyo
ncb lang=Central
ncc lang=Ponam
ncd lang=Nachering
nce lang=Yale
ncf lang=Notsi
ncg lang=Nisga'a
nch lang=Central
nci lang=Classical
ncj lang=Northern
nck lang=Nakara
ncl lang=Michoacán
ncm lang=Nambo
ncn lang=Nauna
nco lang=Sibe
ncr lang=Ncane
ncs lang=Nicaraguan
nct lang=Chothe
ncu lang=Chumburung
ncx lang=Central
ncz lang=Natchez
nda lang=Ndasa
ndb lang=Kenswei
ndc lang=Ndau
ndd lang=Nde-Nsele-Nta
ndf lang=Nadruvian
ndg lang=Ndengereko
ndh lang=Ndali
ndi lang=Chamba
ndj lang=Ndamba
ndk lang=Ndaka
ndl lang=Ndolo
ndm lang=Ndam
ndn lang=Ngundi
ndp lang=Ndo
ndq lang=Ndombe
ndr lang=Ndoola
nds lang=Low
ndt lang=Ndunga
ndu lang=Dugun
ndv lang=Ndut
ndw lang=Ndobo
ndx lang=Nduga
ndy lang=Lutos
ndz lang=Ndogo
nea lang=Eastern
neb lang=Toura
nec lang=Nedebang
ned lang=Nde-Gbite
nee lang=Kumak
nef lang=Nefamese
neg lang=Negidal
neh lang=Nyenkha
nej lang=Neko
nek lang=Neku
nem lang=Nemi
nen lang=Nengone
neo lang=Ná-Meo
neq lang=North
ner lang=Yahadian
nes lang=Bhoti
net lang=Nete
neu lang=Neo
nev lang=Nyaheun
new lang=Newar
nex lang=Neme
ney lang=Neyo
nez lang=Nez
nfa lang=Dhao
nfd lang=Ahwai
nfl lang=Aiwoo
nfr lang=Nafaanra
nfu lang=Mfumte
nga lang=Ngbaka
ngb lang=Northern
ngc lang=Ngombe
ngd lang=Ngando
nge lang=Ngemba
ngg lang=Ngbaka
ngh lang=Nǀuu
ngi lang=Ngizim
ngj lang=Ngie
ngk lang=Ngalkbun
ngl lang=Lomwe
ngm lang=Ngatik
ngn lang=Ngwo
ngo lang=Ngoni
ngp lang=Ngulu
ngq lang=Ngoreme
ngr lang=Nagu
ngs lang=Gvoko
ngt lang=Ngeq
ngu lang=Guerrero
ngv lang=Nagumi
ngw lang=Ngwaba
ngx lang=Nggwahyi
ngy lang=Tibea
ngz lang=Ngungwel
nha lang=Nhanda
nhb lang=Beng
nhc lang=Tabasco
nhd lang=Chiripá
nhe lang=Eastern
nhf lang=Nhuwala
nhg lang=Tetelcingo
nhh lang=Nahari
nhi lang=Zacatlán-Ahuacatlán-Tepetzintla
nhk lang=Cosoleacaque
nhm lang=Morelos
nhn lang=Central
nho lang=Takuu
nhp lang=Pajapan
nhq lang=Huaxcaleca
nhr lang=Naro
nht lang=Ometepec
nhu lang=Noone
nhv lang=Temascaltepec
nhw lang=Western
nhx lang=Mecayapan
nhy lang=Northern
nhz lang=Santa
nia lang=Nias
nib lang=Nakame
nid lang=Ngandi
nie lang=Niellim
nif lang=Nek
nig lang=Ngalakan
nih lang=Nyiha
nii lang=Nii
nij lang=Ngaju
nik lang=Southern
nil lang=Nila
nim lang=Nilamba
nin lang=Ninzo
nio lang=Nganasan
niq lang=Nandi
nir lang=Nimboran
nis lang=Nimi
nit lang=Southeastern
niu lang=Niuean
niv lang=Nivkh
niw lang=Nimo
nix lang=Hema
niy lang=Ngiti
niz lang=Ningil
nja lang=Nzanyi
njb lang=Nocte
njh lang=Lotha
nji lang=Gudanji
njj lang=Njen
njl lang=Njalgulgule
njm lang=Angami
njn lang=Liangmai
njo lang=Ao
njr lang=Njerep
njs lang=Nisa
njt lang=Ndyuka-Trio
nju lang=Ngadjunmaya
njx lang=Kunyi
njy lang=Njyem
njz lang=Nyishi
nka lang=Nkoya
nkb lang=Khoibu
nkc lang=Nkongho
nkd lang=Koireng
nke lang=Duke
nkf lang=Inpui
nkg lang=Nekgini
nkh lang=Khezha
nki lang=Thangal
nkj lang=Nakai
nkk lang=Nokuku
nkm lang=Namat
nkn lang=Nkangala
nko lang=Nkonya
nkp lang=Niuatoputapu
nkq lang=Nkami
nkr lang=Nukuoro
nks lang=North
nkt lang=Nyika
nku lang=Bouna
nkw lang=Nkutu
nkx lang=Nkoroo
nkz lang=Nkari
nla lang=Ngombale
nlc lang=Nalca
nle lang=East
nlg lang=Gela
nli lang=Grangali
nlj lang=Nyali
nlk lang=Ninia
nll lang=Nihali
nlm lang=Mankiyali
nlo lang=Ngul
nlq lang=Lao
nlu lang=Nchumbulu
nlv lang=Orizaba
nlw lang=Walangama
nlx lang=Nahali
nly lang=Nyamal
nlz lang=Nalögo
nma lang=Maram
nmb lang=Big
nmc lang=Ngam
nmd lang=Ndumu
nme lang=Mzieme
nmf lang=Tangkhul
nmg lang=Kwasio
nmh lang=Monsang
nmi lang=Nyam
nmj lang=Ngombe
nmk lang=Namakura
nml lang=Ndemli
nmm lang=Manangba
nmn lang=ǃXóõ
nmo lang=Moyon
nmp lang=Nimanbur
nmq lang=Nambya
nmr lang=Nimbari
nms lang=Letemboi
nmt lang=Namonuito
nmu lang=Northeast
nmv lang=Ngamini
nmw lang=Nimoa
nmy lang=Namuyi
nmz lang=Nawdm
nna lang=Nyangumarta
nnb lang=Nande
nnc lang=Nancere
nnd lang=West
nne lang=Ngandyera
nnf lang=Ngaing
nng lang=Maring
nnh lang=Ngiemboon
nni lang=North
nnj lang=Nyangatom
nnk lang=Nankina
nnl lang=Northern
nnm lang=Namia
nnn lang=Ngete
nnp lang=Wancho
nnq lang=Ngindo
nnr lang=Narungga
nnt lang=Nanticoke
nnu lang=Dwang
nnv lang=Nukunu
nnw lang=Southern
nnx lang=Ngong
nny lang=Nyangga
nnz lang=Nda'nda'
noa lang=Woun
noc lang=Nuk
nod lang=Northern
noe lang=Nimadi
nof lang=Nomane
nog lang=Nogai
noh lang=Nomu
noi lang=Noiri
noj lang=Nonuya
nok lang=Nooksack
nol lang=Nomlaki
nom lang=Nocamán
non lang=Old
nop lang=Numanggang
noq lang=Ngongo
nos lang=Eastern
not lang=Nomatsiguenga
nou lang=Ewage-Notu
nov lang=Novial
now lang=Nyambo
noy lang=Noy
noz lang=Nayi
npa lang=Nar
npb lang=Nupbikha
npg lang=Ponyo
nph lang=Phom
npl lang=Southeastern
npn lang=Mondropolon
npo lang=Pochuri
nps lang=Nipsan
npu lang=Puimei
npy lang=Napu
nqg lang=Ede
nqk lang=Kura
nql lang=Ngendelengo
nqm lang=Ndom
nqn lang=Nen
nqo lang=N'Ko
nqq lang=Kyan-Karyaw
nqy lang=Akyaung
nra lang=Ngom
nrb lang=Nara
nrc lang=Noric
nre lang=Southern
nrf lang=Norman
nrg lang=Narango
nri lang=Chokri
nrk lang=Ngarla
nrl lang=Ngarluma
nrm lang=Narom
nrn lang=Norn
nrp lang=North
nrr lang=Norra
nrt lang=Northern
nru lang=Narua
nrx lang=Ngurmbur
nrz lang=Lala
nsa lang=Sangtam
nsb lang=Lower
nsc lang=Nshi
nsd lang=Southern
nse lang=Nsenga
nsg lang=Ngasa
nsh lang=Ngoshie
nsi lang=Nigerian
nsk lang=Naskapi
nsl lang=Norwegian
nsm lang=Sema
nsn lang=Nehan
nso lang=Northern
nsp lang=Nepalese
nsq lang=Northern
nsr lang=Maritime
nss lang=Nali
nst lang=Tangsa
nsu lang=Sierra
nsv lang=Southwestern
nsw lang=Navut
nsx lang=Nsongo
nsy lang=Nasal
nsz lang=Nisenan
ntd lang=Northern
nte lang=Nathembo
ntg lang=Ngantangarra
nti lang=Natioro
ntj lang=Ngaanyatjarra
ntk lang=Ikoma
ntm lang=Nateni
nto lang=Ntomba
ntp lang=Northern
ntr lang=Delo
nts lang=Natagaimas
ntu lang=Natügu
ntw lang=Nottoway
ntx lang=Somra
nty lang=Mantsi
nua lang=Yuaga
nuc lang=Nukuini
nud lang=Ngala
nue lang=Ngundu
nuf lang=Nusu
nug lang=Nungali
nuh lang=Ndunda
nui lang=Ngumbi
nuj lang=Nyole
nuk lang=Nootka
nul lang=Nusa
num lang=Niuafo'ou
nun lang=Anong
nuo lang=Nguôn
nup lang=Nupe
nuq lang=Nukumanu
nur lang=Nuguria
nus lang=Nuer
nut lang=Nung
nuu lang=Ngbundu
nuv lang=Northern
nuw lang=Nguluwan
nux lang=Mehek
nuy lang=Nunggubuyu
nuz lang=Tlamacazapa
nvh lang=Nasarian
nvm lang=Namiae
nvo lang=Nyokon
nwa lang=Nawathinehena
nwb lang=Nyabwa
nwc lang=Classical
nwe lang=Ngwe
nwi lang=Southwest
nwm lang=Nyamusa-Molo
nwo lang=Nauo
nwr lang=Nawaru
nwx lang=Middle
nwy lang=Nottoway-Meherrin
nxa lang=Nauete
nxd lang=Ngando
nxe lang=Nage
nxg lang=Ngadha
nxi lang=Nindi
nxl lang=South
nxm lang=Numidian
nxn lang=Ngawun
nxo lang=Ndambomo
nxq lang=Naxi
nxr lang=Ninggerum
nxu lang=Narau
nxx lang=Nafri
nyb lang=Nyangbo
nyc lang=Nyanga-li
nyd lang=Nyole
nye lang=Nyengo
nyf lang=Giryama
nyg lang=Nyindu
nyh lang=Nyigina
nyi lang=Nyimang
nyj lang=Nyanga
nyk lang=Nyaneka
nyl lang=Nyeu
nym lang=Nyamwezi
nyn lang=Nyankole
nyo lang=Nyoro
nyp lang=Nyang'i
nys lang=Nyunga
nyt lang=Nyawaygi
nyu lang=Nyungwe
nyv lang=Nyulnyul
nyw lang=Nyaw
nyx lang=Nganyaywana
nyy lang=Nyakyusa
nza lang=Tigon
nzb lang=Njebi
nzd lang=Nzadi
nzi lang=Nzima
nzk lang=Nzakara
nzm lang=Zeme
nzs lang=New
nzu lang=Central
nzy lang=Nzakambay
nzz lang=Nanga
oaa lang=Orok
oac lang=Oroch
oav lang=Old
obi lang=Obispeño
obk lang=Southern
obl lang=Oblo
obm lang=Moabite
obo lang=Obo
obr lang=Old
obt lang=Old
obu lang=Obulom
oca lang=Ocaina
och lang=Old
oco lang=Old
ocu lang=Tlahuica
oda lang=Odut
odk lang=Od
odt lang=Old
odu lang=Odual
ofo lang=Ofo
ofs lang=Old
ofu lang=Efutop
ogb lang=Ogbia
ogc lang=Ogbah
oge lang=Old
ogg lang=Ogbogolo
ogo lang=Khana
ogu lang=Ogbronuagum
ohu lang=Old
oia lang=Oirata
oin lang=Inebu
ojb lang=Northwestern
ojc lang=Central
ojg lang=Eastern
ojp lang=Old
ojs lang=Severn
ojv lang=Ontong
ojw lang=Western
oka lang=Okanagan
okb lang=Okobo
okd lang=Okodia
oke lang=Okpe
okg lang=Kok-Paponk
okh lang=Koresh-e
oki lang=Okiek
okj lang=Oko-Juwoi
okk lang=Kwamtim
okl lang=Old
okm lang=Middle
okn lang=Oki-No-Erabu
oko lang=Old
okr lang=Kirike
oks lang=Oko-Eni-Osayen
oku lang=Oku
okv lang=Orokaiva
okx lang=Okpe
okz lang=Old
old lang=Mochi
ole lang=Olekha
olm lang=Oloma
olo lang=Livvi
olr lang=Olrat
olt lang=Old
olu lang=Kuvale
oma lang=Omaha-Ponca
omb lang=Omba
omc lang=Mochica
omg lang=Omagua
omi lang=Omi
omk lang=Omok
oml lang=Ombo
omn lang=Minoan
omo lang=Utarmbung
omp lang=Old
omr lang=Old
omt lang=Omotik
omu lang=Omurano
omw lang=South
omx lang=Old
ona lang=Selk'nam
onb lang=Lingao
one lang=Oneida
ong lang=Olo
oni lang=Onin
onj lang=Onjob
onk lang=Kabore
onn lang=Onobasulu
ono lang=Onondaga
onp lang=Sartang
onr lang=Northern
ons lang=Ono
ont lang=Ontenu
onu lang=Unua
onw lang=Old
onx lang=Pidgin
ood lang=O'odham
oog lang=Ong
oon lang=Önge
oor lang=Oorlams
oos lang=Old
opa lang=Okpamheri
opk lang=Kopkaka
opm lang=Oksapmin
opo lang=Opao
opt lang=Opata
opy lang=Ofayé
ora lang=Oroha
ore lang=Orejón
org lang=Oring
orh lang=Oroqen
oro lang=Orokolo
orr lang=Oruma
ort lang=Adivasi
oru lang=Ormuri
orv lang=Old
orw lang=Oro
orx lang=Oro
orz lang=Ormu
osa lang=Osage
osc lang=Oscan
osi lang=Osing
osn lang=Old
oso lang=Ososo
osp lang=Old
ost lang=Osatu
osu lang=Southern
osx lang=Old
ota lang=Ottoman
otd lang=Ot
ote lang=Mezquital
oti lang=Oti
otk lang=Old
otl lang=Tilapa
otm lang=Eastern
otn lang=Tenango
otq lang=Querétaro
otr lang=Otoro
ots lang=Estado
ott lang=Temoaya
otu lang=Otuke
otw lang=Ottawa
otx lang=Texcatepec
oty lang=Old
otz lang=Ixtenco
oub lang=Glio-Oubi
oue lang=Oune
oui lang=Old
oum lang=Ouma
ovd lang=Elfdalian
owi lang=Owiniga
owl lang=Old
oyb lang=Oy
oyd lang=Oyda
oym lang=Wayampi
oyy lang=Oya'oya
ozm lang=Koonzime
pab lang=Pareci
pac lang=Pacoh
pad lang=Paumarí
pae lang=Pagibete
paf lang=Paranawát
pag lang=Pangasinan
pah lang=Tenharim
pai lang=Pe
pak lang=Parakanã
pal lang=Middle
pam lang=Kapampangan
pao lang=Northern
pap lang=Papiamentu
paq lang=Parya
par lang=Panamint
pas lang=Papasena
pat lang=Papitalai
pau lang=Palauan
pav lang=Wari'
paw lang=Pawnee
pax lang=Pankararé
pay lang=Pech
paz lang=Pankararú
pbb lang=Páez
pbc lang=Patamona
pbe lang=Mezontla
pbf lang=Coyotepec
pbg lang=Paraujano
pbh lang=Panare
pbi lang=Podoko
pbl lang=Mak
pbm lang=Puebla
pbn lang=Kpasam
pbo lang=Papel
pbp lang=Badyara
pbr lang=Pangwa
pbs lang=Central
pbv lang=Pnar
pby lang=Pyu
pca lang=Santa
pcb lang=Pear
pcc lang=Bouyei
pcd lang=Picard
pce lang=Ruching
pcf lang=Paliyan
pcg lang=Paniya
pch lang=Pardhan
pci lang=Duruwa
pcj lang=Parenga
pck lang=Paite
pcl lang=Pardhi
pcm lang=Nigerian
pcn lang=Piti
pcp lang=Pacahuara
pcw lang=Pyapun
pda lang=Anam
pdc lang=Pennsylvania
pdi lang=Pa
pdn lang=Fedan
pdo lang=Padoe
pdt lang=Plautdietsch
pdu lang=Kayan
pea lang=Peranakan
peb lang=Eastern
ped lang=Mala
pee lang=Taje
pef lang=Northeastern
peg lang=Pengo
peh lang=Bonan
pei lang=Chichimeca-Jonaz
pej lang=Northern
pek lang=Penchal
pel lang=Pekal
pem lang=Phende
peo lang=Old
pep lang=Kunja
peq lang=Southern
pev lang=Pémono
pex lang=Petats
pey lang=Petjo
pez lang=Eastern
pfa lang=Pááfang
pfe lang=Peere
pga lang=Juba
pgd lang=Gandhari
pgg lang=Pangwali
pgi lang=Pagi
pgk lang=Rerep
pgl lang=Primitive
pgn lang=Paelignian
pgs lang=Pangseng
pgu lang=Pagu
pgz lang=Papua
pha lang=Pa-Hng
phd lang=Phudagi
phg lang=Phuong
phh lang=Phukha
phk lang=Phake
phl lang=Phalura
phm lang=Phimbi
phn lang=Phoenician
pho lang=Phunoi
phq lang=Phana'
phr lang=Pahari-Potwari
pht lang=Phu
phu lang=Phuan
phv lang=Pahlavani
phw lang=Phangduwali
pia lang=Pima
pib lang=Yine
pic lang=Pinji
pid lang=Piaroa
pie lang=Piro
pif lang=Pingelapese
pig lang=Pisabo
pih lang=Pitcairn-Norfolk
pii lang=Pini
pij lang=Pijao
pil lang=Yom
pim lang=Powhatan
pin lang=Piame
pio lang=Piapoco
pip lang=Pero
pir lang=Piratapuyo
pis lang=Pijin
pit lang=Pitta-Pitta
piu lang=Pintupi-Luritja
piv lang=Pileni
piw lang=Pimbwe
pix lang=Piu
piy lang=Piya-Kwonci
piz lang=Pije
pjt lang=Pitjantjatjara
pka lang=Ardhamagadhi
pkb lang=Kipfokomo
pkc lang=Baekje
pkg lang=Pak-Tong
pkh lang=Pankhu
pkn lang=Pakanha
pko lang=Pökoot
pkp lang=Pukapukan
pkr lang=Attapady
pks lang=Pakistan
pkt lang=Maleng
pku lang=Paku
pla lang=Miani
plb lang=Polonombauk
plc lang=Central
ple lang=Palu'e
plg lang=Pilagá
plh lang=Paulohi
plj lang=Polci
plk lang=Kohistani
pll lang=Shwe
pln lang=Palenquero
plo lang=Oluta
plq lang=Palaic
plr lang=Palaka
pls lang=San
plu lang=Palikur
plv lang=Southwest
plw lang=Brooke's
ply lang=Bolyu
plz lang=Paluan
pma lang=Paama
pmb lang=Pambia
pmd lang=Pallanganmiddang
pme lang=Pwaamei
pmf lang=Pamona
pmh lang=Maharastri
pmi lang=Northern
pmj lang=Southern
pmk lang=Pamlico
pml lang=Sabir
pmm lang=Pol
pmn lang=Pam
pmo lang=Pom
pmq lang=Northern
pmr lang=Paynamar
pms lang=Piedmontese
pmt lang=Tuamotuan
pmu lang=Mirpur
pmw lang=Plains
pmx lang=Poumei
pmy lang=Papuan
pmz lang=Southern
pna lang=Punan
pnb lang=Western
pnc lang=Pannei
pnd lang=Mpinda
pne lang=Western
png lang=Pongu
pnh lang=Penrhyn
pni lang=Aoheng
pnj lang=Pinjarup
pnk lang=Paunaca
pnl lang=Paleni
pnm lang=Punan
pnn lang=Pinai-Hagahai
pno lang=Panobo
pnp lang=Pancana
pnq lang=Pana
pnr lang=Panim
pns lang=Ponosakan
pnt lang=Pontic
pnu lang=Jiongnai
pnv lang=Pinigura
pnw lang=Panyjima
pnx lang=Phong-Kniang
pny lang=Pinyin
pnz lang=Pana
poc lang=Poqomam
poe lang=San
pof lang=Poke
pog lang=Potiguára
poh lang=Poqomchi'
poi lang=Highland
pok lang=Pokangá
pom lang=Southeastern
pon lang=Pohnpeian
poo lang=Central
pop lang=Pwapwa
poq lang=Texistepec
pos lang=Sayula
pot lang=Potawatomi
pov lang=Guinea-Bissau
pow lang=San
pox lang=Polabian
poy lang=Pogolo
ppa lang=Pao
ppe lang=Papi
ppi lang=Paipai
ppk lang=Uma
ppl lang=Pipil
ppm lang=Papuma
ppn lang=Papapana
ppo lang=Folopa
ppq lang=Pei
pps lang=San
ppt lang=Pa
ppu lang=Papora
pqa lang=Pa'a
pqm lang=Malecite-Passamaquoddy
prc lang=Parachi
pre lang=Principense
prf lang=Paranan
prg lang=Old
prh lang=Porohanon
pri lang=Paicî
prk lang=Parauk
prl lang=Peruvian
prm lang=Kibiri
prn lang=Prasuni
pro lang=Old
prq lang=Ashéninka
prr lang=Puri
prt lang=Phai
pru lang=Puragi
prw lang=Parawen
prx lang=Purik
prz lang=Providencia
psa lang=Asue
psc lang=Persian
psd lang=Plains
pse lang=Central
psg lang=Penang
psh lang=Southwest
psi lang=Southeast
psl lang=Puerto
psm lang=Pauserna
psn lang=Panasuan
pso lang=Polish
psp lang=Philippine
psq lang=Pasi
psr lang=Portuguese
pss lang=Kaulong
psu lang=Sauraseni
psw lang=Port
psy lang=Piscataway
pta lang=Pai
pth lang=Pataxó
pti lang=Pintiini
ptn lang=Patani
pto lang=Zo'é
ptp lang=Patep
ptq lang=Pattapu
ptr lang=Piamatsina
ptt lang=Enrekang
ptu lang=Bambam
ptv lang=Port
ptw lang=Pentlatch
pty lang=Pathiya
pua lang=Purepecha
pub lang=Purum
puc lang=Punan
pud lang=Punan
pue lang=Puelche
puf lang=Punan
pug lang=Phuie
pui lang=Puinave
puj lang=Punan
pum lang=Puma
puo lang=Puoc
pup lang=Pulabu
puq lang=Puquina
pur lang=Puruborá
put lang=Putoh
puu lang=Punu
puw lang=Puluwat
pux lang=Puare
puy lang=Purisimeño
pwa lang=Pawaia
pwb lang=Panawa
pwg lang=Gapapaiwa
pwi lang=Patwin
pwm lang=Molbog
pwn lang=Paiwan
pwo lang=Western
pwr lang=Powari
pww lang=Northern
pxm lang=Quetzaltepec
pye lang=Pye
pym lang=Fyam
pyn lang=Poyanáwa
pys lang=Paraguayan
pyu lang=Puyuma
pyx lang=Tircul
pyy lang=Pyen
pzh lang=Pazeh
pzn lang=Para
qua lang=Quapaw
quc lang=K'iche'
qui lang=Quileute
qum lang=Sipakapense
qun lang=Quinault
quq lang=Quinqui
quv lang=Sacapulteco
qvy lang=Queyu
qwc lang=Classical
qwm lang=Kipchak
qwt lang=Kwalhioqua-Tlatskanai
qxs lang=Southern
qya lang=Quenya
qyp lang=Quiripi
raa lang=Dungmali
rab lang=Chamling
rac lang=Rasawa
rad lang=Rade
raf lang=Western
rag lang=Logooli
rah lang=Rabha
rai lang=Ramoaaina
raj lang=Rajasthani
rak lang=Tulu-Bohuai
ral lang=Ralte
ram lang=Canela
ran lang=Riantana
rao lang=Rao
rap lang=Rapa
raq lang=Saam
rar lang=Rarotongan
ras lang=Tegali
rat lang=Razajerdi
rau lang=Raute
rav lang=Sampang
raw lang=Rawang
rax lang=Rang
ray lang=Rapa
raz lang=Rahambuu
rbb lang=Rumai
rbk lang=Northern
rbl lang=Miraya
rcf lang=Réunion
rdb lang=Rudbari
rea lang=Rerau
reb lang=Rembong
ree lang=Rejang
reg lang=Kara
rei lang=Reli
rej lang=Rejang
rel lang=Rendille
rem lang=Remo
ren lang=Rengao
rer lang=Rer
res lang=Reshe
ret lang=Retta
rey lang=Reyesano
rga lang=Roria
rge lang=Romani
rgk lang=Rangkas
rgn lang=Romagnol
rgr lang=Resígaro
rgs lang=Southern
rgu lang=Ringgou
rhg lang=Rohingya
rhp lang=Yahang
ria lang=Reang
rif lang=Tarifit
ril lang=Riang
rim lang=Nyaturu
rin lang=Nungu
rir lang=Ribun
rit lang=Ritarungo
riu lang=Riung
rjg lang=Rajong
rji lang=Raji
rjs lang=Rajbanshi
rka lang=Kraol
rkb lang=Rikbaktsa
rkh lang=Rakahanga-Manihiki
rki lang=Rakhine
rkm lang=Marka
rkt lang=Kamta
rkw lang=Arakwal
rma lang=Rama
rmb lang=Rembarunga
rmc lang=Carpathian
rmd lang=Traveller
rme lang=Angloromani
rmf lang=Kalo
rmg lang=Traveller
rmh lang=Murkim
rmi lang=Lomavren
rmk lang=Romkun
rml lang=Baltic
rmm lang=Roma
rmn lang=Balkan
rmo lang=Sinte
rmp lang=Rempi
rmq lang=Caló
rms lang=Romanian
rmt lang=Domari
rmu lang=Tavringer
rmv lang=Romanova
rmw lang=Welsh
rmx lang=Romam
rmy lang=Vlax
rmz lang=Marma
rnd lang=Ruwund
rng lang=Ronga
rnl lang=Ranglong
rnn lang=Roon
rnp lang=Rongpo
rnw lang=Rungwa
rob lang=Tae'
roc lang=Cacgia
rod lang=Rogo
roe lang=Ronji
rof lang=Rombo
rog lang=Northern
rol lang=Romblomanon
rom lang=Romani
roo lang=Rotokas
rop lang=Kriol
ror lang=Rongga
rou lang=Runga
row lang=Dela-Oenale
rpn lang=Repanbitip
rpt lang=Rapting
rri lang=Ririo
rro lang=Roro
rrt lang=Arritinngithigh
rsb lang=Romano-Serbian
rsl lang=Russian
rsm lang=Miriwoong
rtc lang=Rungtu
rth lang=Ratahan
rtm lang=Rotuman
rtw lang=Rathawi
rub lang=Gungu
ruc lang=Ruuli
rue lang=Rusyn
ruf lang=Luguru
rug lang=Roviana
ruh lang=Ruga
rui lang=Rufiji
ruk lang=Che
ruo lang=Istro-Romanian
rup lang=Aromanian
ruq lang=Megleno-Romanian
rut lang=Rutul
ruu lang=Lanas
ruy lang=Mala
ruz lang=Ruma
rwa lang=Rawo
rwk lang=Rwa
rwm lang=Amba
rwo lang=Rawa
rxd lang=Ngardi
rxw lang=Karuwali
ryn lang=Northern
rys lang=Yaeyama
ryu lang=Okinawan
rzh lang=Razihi
saa lang=Saba
sab lang=Buglere
sac lang=Fox
sad lang=Sandawe
sae lang=Sabanê
saf lang=Safaliba
sah lang=Yakut
saj lang=Sahu
sak lang=Sake
sam lang=Samaritan
sao lang=Sause
saq lang=Samburu
sar lang=Saraveca
sas lang=Sasak
sat lang=Santali
sau lang=Saleman
sav lang=Saafi-Saafi
saw lang=Sawi
sax lang=Sa
say lang=Saya
saz lang=Saurashtra
sba lang=Ngambay
sbb lang=Simbo
sbc lang=Gele'
sbd lang=Southern
sbe lang=Saliba
sbf lang=Shabo
sbg lang=Seget
sbh lang=Sori-Harengan
sbi lang=Seti
sbj lang=Surbakhal
sbk lang=Safwa
sbl lang=Botolan
sbm lang=Sagala
sbn lang=Sindhi
sbo lang=Sabüm
sbp lang=Sangu
sbq lang=Sileibi
sbr lang=Sembakung
sbs lang=Subiya
sbt lang=Kimki
sbu lang=Stod
sbv lang=Sabine
sbw lang=Simba
sbx lang=Seberuang
sby lang=Soli
sbz lang=Sara
scb lang=Chut
sce lang=Dongxiang
scf lang=San
scg lang=Sanggau
sch lang=Sakachep
sci lang=Sri
sck lang=Sadri
scl lang=Shina
scn lang=Sicilian
sco lang=Scots
scp lang=Yolmo
scq lang=Sa'och
scs lang=North
scu lang=Shumcho
scv lang=Sheni
scw lang=Sha
scx lang=Sicel
sda lang=Toraja-Sa'dan
sdb lang=Shabak
sdc lang=Sassarese
sde lang=Surubu
sdf lang=Sarli
sdg lang=Savi
sdh lang=Southern
sdj lang=Suundi
sdk lang=Sos
sdl lang=Saudi
sdm lang=Semandang
sdn lang=Gallurese
sdo lang=Bukar-Sadung
sdp lang=Sherdukpen
sdr lang=Oraon
sds lang=Tunisian
sdu lang=Sarudu
sdx lang=Sibu
sea lang=Semai
sec lang=Sechelt
sed lang=Sedang
see lang=Seneca
sef lang=Cebaara
seg lang=Segeju
seh lang=Sena
sei lang=Seri
sej lang=Sene
sek lang=Sekani
sel lang=Selkup
sen lang=Nanerigé
seo lang=Suarmin
sep lang=Sìcìté
seq lang=Senara
ser lang=Serrano
ses lang=Koyraboro
set lang=Sentani
seu lang=Serui-Laut
sev lang=Nyarafolo
sew lang=Sewa
sey lang=Secoya
sez lang=Senthang
sfb lang=French
sfm lang=Small
sfs lang=South
sfw lang=Sehwi
sga lang=Old
sgb lang=Mag-Anchi
sgc lang=Kipsigis
sgd lang=Surigaonon
sge lang=Segai
sgg lang=Swiss-German
sgh lang=Shughni
sgi lang=Suga
sgk lang=Sangkong
sgm lang=Singa
sgp lang=Singpho
sgr lang=Sangisari
sgs lang=Samogitian
sgt lang=Brokpake
sgu lang=Salas
sgw lang=Sebat
sgx lang=Sierra
sgy lang=Sanglechi
sgz lang=Sursurunga
sha lang=Shall-Zwall
shb lang=Ninam
shc lang=Sonde
shd lang=Kundal
she lang=Sheko
shg lang=Shua
shh lang=Shoshone
shi lang=Tashelhit
shj lang=Shatt
shk lang=Shilluk
shl lang=Shendu
shm lang=Shahrudi
shn lang=Shan
sho lang=Shanga
shp lang=Shipibo-Conibo
shq lang=Sala
shr lang=Shi
shs lang=Shuswap
sht lang=Shasta
shu lang=Chadian
shv lang=Shehri
shw lang=Shwai
shx lang=She
shy lang=Tachawit
shz lang=Syenara
sia lang=Akkala
sib lang=Sebop
sid lang=Sidamo
sie lang=Simaa
sif lang=Siamou
sig lang=Paasaal
sih lang=Zire
sii lang=Shom
sij lang=Numbami
sik lang=Sikiana
sil lang=Tumulung
sim lang=Seim
sip lang=Sikkimese
siq lang=Sonia
sir lang=Siri
sis lang=Siuslaw
siu lang=Sinagen
siv lang=Sumariup
siw lang=Siwai
six lang=Sumau
siy lang=Sivandi
siz lang=Siwi
sja lang=Epena
sjb lang=Sajau
sjd lang=Kildin
sje lang=Pite
sjg lang=Assangori
sjk lang=Kemi
sjl lang=Miji
sjm lang=Mapun
sjn lang=Sindarin
sjo lang=Xibe
sjp lang=Surjapuri
sjr lang=Siar-Lak
sjs lang=Senhaja
sjt lang=Ter
sju lang=Ume
sjw lang=Shawnee
ska lang=Skagit
skb lang=Saek
skc lang=Ma
skd lang=Southern
ske lang=Ske
skf lang=Sakirabiá
skh lang=Sikule
ski lang=Sika
skj lang=Seke
skk lang=Sok
skm lang=Sakam
skn lang=Kolibugan
sko lang=Seko
skp lang=Sekapan
skq lang=Sininkere
skr lang=Saraiki
sks lang=Maia
skt lang=Sakata
sku lang=Sakao
skv lang=Skou
skw lang=Skepi
skx lang=Seko
sky lang=Sikaiana
skz lang=Sekar
slc lang=Saliba
sld lang=Sissala
sle lang=Sholaga
slf lang=Swiss-Italian
slg lang=Selungai
slh lang=Southern
slj lang=Salumá
sll lang=Salt-Yui
slm lang=Pangutaran
sln lang=Salinan
slp lang=Lamaholot
slq lang=Salchuq
slr lang=Salar
sls lang=Singapore
slt lang=Sila
slu lang=Selaru
slw lang=Sialum
slx lang=Salampasu
sly lang=Selayar
slz lang=Ma'ya
sma lang=Southern
smb lang=Simbari
smc lang=Som
smd lang=Sama
smf lang=Auwe
smg lang=Simbali
smh lang=Samei
smj lang=Lule
smk lang=Bolinao
sml lang=Central
smm lang=Musasa
smn lang=Inari
smp lang=Samaritan
smq lang=Samo
smr lang=Simeulue
sms lang=Skolt
smt lang=Simte
smu lang=Somray
smv lang=Samvedi
smw lang=Sumbawa
smx lang=Samba
smy lang=Semnani
smz lang=Simeku
snb lang=Sebuyau
snc lang=Sinaugoro
sne lang=Bau
snf lang=Noon
sng lang=Sanga
sni lang=Sensi
snj lang=Riverain
snk lang=Soninke
snl lang=Sangil
snm lang=Southern
snn lang=Siona
sno lang=Snohomish
snp lang=Siane
snq lang=Sangu
snr lang=Sihan
sns lang=Nahavaq
snu lang=Senggi
snv lang=Sa'ban
snw lang=Selee
snx lang=Sam
sny lang=Saniyo-Hiyewe
snz lang=Kou
soa lang=Thai
sob lang=Sobei
soc lang=Soko
sod lang=Songoora
soe lang=Songomeno
sog lang=Sogdian
soh lang=Aka
soi lang=Sonha
sok lang=Sokoro
sol lang=Solos
soo lang=Nsong
sop lang=Songe
soq lang=Kanasi
sor lang=Somrai
sos lang=Seenku
sou lang=Southern
sov lang=Sonsorolese
sow lang=Sowanda
sox lang=Swo
soy lang=Miyobe
soz lang=Temi
spb lang=Sepa
spc lang=Sapé
spd lang=Saep
spe lang=Sepa
spg lang=Sian
spi lang=Saponi
spk lang=Sengo
spl lang=Selepet
spm lang=Sepen
spn lang=Sanapaná
spo lang=Spokane
spp lang=Supyire
spr lang=Saparua
sps lang=Saposa
spt lang=Spiti
spu lang=Sapuan
spv lang=Sambalpuri
spx lang=South
spy lang=Sabaot
sqa lang=Shama-Sambuga
sqh lang=Shau
sqk lang=Albanian
sqm lang=Suma
sqn lang=Susquehannock
sqo lang=Sorkhei
sqq lang=Sou
sqr lang=Siculo-Arabic
sqs lang=Sri
sqt lang=Soqotri
squ lang=Squamish
sra lang=Saruga
srb lang=Sora
sre lang=Sara
srf lang=Nafi
srg lang=Sulod
srh lang=Sarikoli
sri lang=Siriano
srk lang=Serudung
srl lang=Isirawa
srm lang=Saramaccan
srn lang=Sranan
srq lang=Sirionó
srr lang=Serer
srs lang=Sarcee
srt lang=Sauri
sru lang=Suruí
srv lang=Waray
srw lang=Serua
srx lang=Sirmauri
sry lang=Sera
srz lang=Shahmirzadi
ssb lang=Southern
ssc lang=Suba-Simbiti
ssd lang=Siroi
sse lang=Balangingi
ssf lang=Thao
ssg lang=Seimat
ssh lang=Shihhi
ssi lang=Sansi
ssj lang=Sausi
ssk lang=Sunam
ssl lang=Western
ssm lang=Semnam
sso lang=Sissano
ssp lang=Spanish
ssq lang=So'a
ssr lang=Swiss-French
sss lang=Sô
sst lang=Sinasina
ssu lang=Susuami
ssv lang=Shark
ssx lang=Samberigi
ssy lang=Saho
ssz lang=Sengseng
stb lang=Northern
std lang=Sentinelese
ste lang=Liana-Seti
stf lang=Seta
stg lang=Trieng
sth lang=Shelta
sti lang=Bulo
stj lang=Matya
stk lang=Arammba
stm lang=Setaman
stn lang=Owa
sto lang=Stoney
stp lang=Southeastern
stq lang=Saterland
str lang=Saanich
sts lang=Shumashti
stt lang=Budeh
stu lang=Samtao
stv lang=Silt'e
stw lang=Satawalese
sty lang=Siberian
sua lang=Sulka
sub lang=Suku
suc lang=Western
sue lang=Suena
sug lang=Suganga
sui lang=Suki
suk lang=Sukuma
suq lang=Suri
sur lang=Mwaghavul
sus lang=Susu
sut lang=Subtiaba
suv lang=Sulung
suw lang=Sumbwa
sux lang=Sumerian
suy lang=Suyá
suz lang=Sunwar
sva lang=Svan
svb lang=Ulau-Suain
svc lang=Vincentian
sve lang=Serili
svk lang=Slovakian
svm lang=Slavomolisano
svs lang=Savosavo
svx lang=Skalvian
swb lang=Maore
swf lang=Sere
swg lang=Swabian
swi lang=Sui
swj lang=Sira
swl lang=Swedish
swm lang=Samosa
swn lang=Sokna
swo lang=Shanenawa
swp lang=Suau
swq lang=Sharwa
swr lang=Saweru
sws lang=Seluwasan
swt lang=Sawila
swu lang=Suwawa
sww lang=Sowa
swx lang=Suruahá
swy lang=Sarua
sxb lang=Suba
sxc lang=Sicanian
sxe lang=Sighu
sxg lang=Shixing
sxk lang=Southern
sxl lang=Selonian
sxm lang=Samre
sxn lang=Sangir
sxo lang=Sorothaptic
sxr lang=Saaroa
sxs lang=Sasaru
sxw lang=Saxwe
sya lang=Siang
syb lang=Central
syc lang=Classical
syi lang=Seki
syk lang=Sukur
syl lang=Sylheti
sym lang=Maya
syn lang=Senaya
syo lang=Suoy
sys lang=Sinyar
syw lang=Kagate
syx lang=Osamayi
syy lang=Al-Sayyid
sza lang=Semelai
szb lang=Ngalum
szc lang=Semaq
szd lang=Seru
sze lang=Seze
szg lang=Sengele
szl lang=Silesian
szn lang=Sula
szp lang=Suabo
szv lang=Isubu
szw lang=Sawai
szy lang=Sakizaya
taa lang=Lower
tab lang=Tabasaran
tac lang=Lowland
tad lang=Tause
tae lang=Tariana
taf lang=Tapirapé
tag lang=Tagoi
taj lang=Eastern
tak lang=Tala
tal lang=Tal
tan lang=Tangale
tao lang=Yami
tap lang=Taabwa
tar lang=Central
tas lang=Tay
tau lang=Upper
tav lang=Tatuyo
taw lang=Tai
tax lang=Tamki
tay lang=Atayal
taz lang=Tocho
tba lang=Aikanã
tbb lang=Tapeba
tbc lang=Takia
tbd lang=Kaki
tbe lang=Tanimbili
tbf lang=Mandara
tbg lang=North
tbh lang=Thurawal
tbi lang=Gaam
tbj lang=Tiang
tbk lang=Calamian
tbl lang=Tboli
tbm lang=Tagbu
tbn lang=Barro
tbo lang=Tawala
tbp lang=Taworta
tbr lang=Tumtum
tbs lang=Tanguat
tbt lang=Kitembo
tbu lang=Tubar
tbv lang=Tobo
tbw lang=Tagbanwa
tbx lang=Kapin
tby lang=Tabaru
tbz lang=Ditammari
tca lang=Ticuna
tcb lang=Tanacross
tcc lang=Datooga
tcd lang=Tafi
tce lang=Southern
tcf lang=Malinaltepec
tcg lang=Tamagario
tch lang=Turks
tci lang=Wára
tck lang=Tchitchege
tcl lang=Taman
tcm lang=Tanahmerah
tco lang=Taungyo
tcp lang=Tawr
tcq lang=Kaiy
tcs lang=Torres
tct lang=T'en
tcu lang=Southeastern
tcw lang=Tecpatlán
tcx lang=Toda
tcy lang=Tulu
tcz lang=Thado
tda lang=Tagdal
tdb lang=Panchpargania
tdc lang=Emberá-Tadó
tdd lang=Tai
tde lang=Tiranige
tdf lang=Talieng
tdg lang=Western
tdh lang=Thulung
tdi lang=Tomadino
tdj lang=Tajio
tdk lang=Tambas
tdl lang=Sur
tdm lang=Taruma
tdn lang=Tondano
tdo lang=Teme
tdq lang=Tita
tdr lang=Todrah
tds lang=Doutai
tdt lang=Tetun
tdu lang=Tempasuk
tdv lang=Toro
tdy lang=Tadyawan
tea lang=Temiar
teb lang=Tetete
tec lang=Terik
ted lang=Tepo
tee lang=Huehuetla
tef lang=Teressa
teg lang=Teke-Tege
teh lang=Tehuelche
tei lang=Torricelli
tek lang=Ibali
tem lang=Temne
ten lang=Tama
teo lang=Ateso
tep lang=Tepecano
teq lang=Temein
ter lang=Tereno
tes lang=Tengger
tet lang=Tetum
teu lang=Soo
tev lang=Teor
tew lang=Tewa
tex lang=Tennet
tey lang=Tulishi
tez lang=Tetserret
tfi lang=Tofin
tfn lang=Dena'ina
tfo lang=Tefaro
tfr lang=Teribe
tft lang=Ternate
tga lang=Sagalla
tgb lang=Tobilung
tgc lang=Tigak
tgd lang=Ciwogai
tge lang=Eastern
tgf lang=Chali
tgh lang=Tobagonian
tgi lang=Lawunuia
tgn lang=Tandaganon
tgo lang=Sudest
tgp lang=Tangoa
tgq lang=Tring
tgr lang=Tareng
tgs lang=Nume
tgt lang=Central
tgu lang=Tanggu
tgv lang=Tingui-Boto
tgw lang=Tagwana
tgx lang=Tagish
tgy lang=Togoyo
thc lang=Tai
thd lang=Kuuk
the lang=Chitwania
thf lang=Thangmi
thh lang=Northern
thi lang=Tai
thk lang=Tharaka
thl lang=Dangaura
thm lang=Thavung
thn lang=Thachanadan
thp lang=Thompson
thq lang=Kochila
thr lang=Rana
ths lang=Thakali
tht lang=Tahltan
thu lang=Thuri
thy lang=Tha
tic lang=Tira
tif lang=Tifal
tig lang=Tigre
tih lang=Timugon
tii lang=Tiene
tij lang=Tilung
tik lang=Tikar
til lang=Tillamook
tim lang=Timbe
tin lang=Tindi
tio lang=Teop
tip lang=Trimuris
tiq lang=Tiéfo
tis lang=Masadiit
tit lang=Tinigua
tiu lang=Adasen
tiv lang=Tiv
tiw lang=Tiwi
tix lang=Southern
tiy lang=Tiruray
tiz lang=Tai
tja lang=Tajuasohn
tjg lang=Tunjung
tji lang=Northern
tjl lang=Tai
tjm lang=Timucua
tjn lang=Tonjon
tjs lang=Southern
tju lang=Tjurruru
tjw lang=Chaap
tka lang=Truká
tkb lang=Buksa
tkd lang=Tukudede
tke lang=Takwane
tkf lang=Tukumanféd
tkl lang=Tokelauan
tkm lang=Takelma
tkn lang=Toku-No-Shima
tkp lang=Tikopia
tkq lang=Tee
tkr lang=Tsakhur
tks lang=Ramandi
tkt lang=Kathoriya
tku lang=Upper
tkv lang=Mur
tkw lang=Teanu
tkx lang=Tangko
tkz lang=Takua
tla lang=Southwestern
tlb lang=Tobelo
tlc lang=Misantla
tld lang=Talaud
tlf lang=Telefol
tlg lang=Tofanma
tlh lang=Klingon
tli lang=Tlingit
tlj lang=Talinga-Bwisi
tlk lang=Taloki
tll lang=Tetela
tlm lang=Tolomako
tln lang=Talondo'
tlo lang=Talodi
tlp lang=Filomena
tlq lang=Tai
tlr lang=Talise
tls lang=Tambotalo
tlt lang=Teluti
tlu lang=Tulehu
tlv lang=Taliabu
tlx lang=Khehek
tly lang=Talysh
tma lang=Tama
tmb lang=Avava
tmc lang=Tumak
tmd lang=Haruai
tme lang=Tremembé
tmf lang=Toba-Maskoy
tmg lang=Ternateño
tmh lang=Tuareg
tmi lang=Tutuba
tmj lang=Samarokena
tmk lang=Northwestern
tml lang=Tamnim
tmm lang=Tai
tmn lang=Taman
tmo lang=Temoq
tmp lang=Tai
tmq lang=Tumleo
tms lang=Tima
tmt lang=Tasmate
tmu lang=Iau
tmv lang=Motembo
tmy lang=Tami
tmz lang=Tamanaku
tna lang=Tacana
tnb lang=Western
tnc lang=Tanimuca-Retuarã
tnd lang=Angosturas
tne lang=Tinoc
tng lang=Tobanga
tnh lang=Maiani
tni lang=Tandia
tnk lang=Kwamera
tnl lang=Lenakel
tnm lang=Tabla
tnn lang=North
tno lang=Toromono
tnp lang=Whitesands
tnq lang=Taíno
tnr lang=Bedik
tns lang=Tenis
tnt lang=Tontemboan
tnu lang=Tay
tnv lang=Tangchangya
tnw lang=Tonsawang
tnx lang=Tanema
tny lang=Tongwe
tnz lang=Ten'edn
tob lang=Toba
toc lang=Coyutla
tod lang=Toma
tof lang=Gizrra
tog lang=Tonga
toh lang=Tonga
toi lang=Tonga
toj lang=Tojolabal
tok lang=Toki
tol lang=Tolowa
tom lang=Tombulu
too lang=Xicotepec
top lang=Papantla
toq lang=Toposa
tor lang=Togbo-Vara
tos lang=Highland
tou lang=Tho
tov lang=Upper
tow lang=Jemez
tox lang=Tobian
toy lang=Topoiyo
toz lang=To
tpa lang=Taupota
tpc lang=Azoyú
tpe lang=Tippera
tpf lang=Tarpia
tpg lang=Kula
tpi lang=Tok
tpj lang=Tapieté
tpk lang=Tupinikin
tpl lang=Tlacoapa
tpm lang=Tampulma
tpn lang=Tupinambá
tpo lang=Tai
tpp lang=Pisaflores
tpq lang=Tukpa
tpr lang=Tuparí
tpt lang=Tlachichilco
tpu lang=Tampuan
tpv lang=Tanapag
tpw lang=Old
tpx lang=Acatepec
tpy lang=Trumai
tpz lang=Tinputz
tqb lang=Tembé
tql lang=Lehali
tqm lang=Turumsa
tqn lang=Tenino
tqo lang=Toaripi
tqp lang=Tomoip
tqq lang=Tunni
tqr lang=Torona
tqt lang=Western
tqu lang=Touo
tqw lang=Tonkawa
tra lang=Tirahi
trb lang=Terebu
trc lang=Copala
trd lang=Turi
tre lang=East
trf lang=Trinidadian
trg lang=Lishán
trh lang=Turaka
tri lang=Trió
trj lang=Toram
trl lang=Traveller
trm lang=Tregami
trn lang=Trinitario
tro lang=Tarao
trp lang=Kokborok
trq lang=San
trr lang=Taushiro
trs lang=Chicahuaxtla
trt lang=Tunggare
tru lang=Turoyo
trv lang=Taroko
trw lang=Torwali
trx lang=Tringgus
try lang=Turung
trz lang=Torá
tsa lang=Tsaangi
tsb lang=Tsamai
tsc lang=Tswa
tsd lang=Tsakonian
tse lang=Tunisian
tsf lang=Southwestern
tsg lang=Tausug
tsh lang=Tsuvan
tsi lang=Tsimshian
tsj lang=Tshangla
tsl lang=Ts'ün-Lao
tsm lang=Turkish
tsp lang=Northern
tsq lang=Thai
tsr lang=Akei
tss lang=Taiwan
tsu lang=Tsou
tsv lang=Tsogo
tsw lang=Tsishingini
tsx lang=Mubami
tsy lang=Tebul
tta lang=Tutelo
ttb lang=Gaa
ttc lang=Tektiteko
ttd lang=Tauade
tte lang=Bwanabwana
ttf lang=Tuotomb
ttg lang=Tutong
tth lang=Upper
tti lang=Tobati
ttj lang=Tooro
ttk lang=Totoro
ttl lang=Totela
ttm lang=Northern
ttn lang=Towei
tto lang=Lower
ttp lang=Tombelala
ttr lang=Tera
tts lang=Isan
ttt lang=Tat
ttu lang=Torau
ttv lang=Titan
ttw lang=Long
tty lang=Sikaritai
ttz lang=Tsum
tua lang=Wiarumus
tub lang=Tübatulabal
tuc lang=Mutu
tud lang=Tuxá
tue lang=Tuyuca
tuf lang=Central
tug lang=Tunia
tuh lang=Taulil
tui lang=Tupuri
tuj lang=Tugutil
tul lang=Tula
tum lang=Tumbuka
tun lang=Tunica
tuo lang=Tucano
tuq lang=Tedaga
tus lang=Tuscarora
tuu lang=Tututni
tuv lang=Turkana
tux lang=Tuxináwa
tuy lang=Tugen
tuz lang=Turka
tva lang=Vaghua
tvd lang=Tsuvadi
tve lang=Te'un
tvk lang=Southeast
tvl lang=Tuvaluan
tvm lang=Tela-Masbuar
tvn lang=Tavoyan
tvo lang=Tidore
tvs lang=Taveta
tvt lang=Tutsa
tvu lang=Tunen
tvw lang=Sedoa
tvx lang=Taivoan
tvy lang=Timor
twa lang=Twana
twb lang=Western
twc lang=Teshenawa
twe lang=Teiwa
twf lang=Taos
twg lang=Tereweng
twh lang=Tai
twm lang=Tawang
twn lang=Twendi
two lang=Tswapong
twp lang=Ere
twq lang=Tasawaq
twr lang=Southwestern
twt lang=Turiwára
twu lang=Termanu
tww lang=Tuwari
twy lang=Tawoyan
txa lang=Tombonuo
txb lang=Tocharian
txc lang=Tsetsaut
txe lang=Totoli
txg lang=Tangut
txh lang=Thracian
txi lang=Ikpeng
txj lang=Tarjumo
txm lang=Tomini
txn lang=West
txo lang=Toto
txq lang=Tii
txr lang=Tartessian
txs lang=Tonsea
txt lang=Citak
txu lang=Kayapó
txx lang=Tatana
tya lang=Tauya
tye lang=Kyenga
tyh lang=O'du
tyi lang=Teke-Tsaayi
tyj lang=Tai
tyl lang=Thu
tyn lang=Kombai
typ lang=Kuku-Thaypan
tyr lang=Tai
tys lang=Sapa
tyt lang=Tày
tyu lang=Kua
tyv lang=Tuvan
tyx lang=Teke-Tyee
tyz lang=Tày
tza lang=Tanzanian
tzh lang=Tzeltal
tzj lang=Tz'utujil
tzl lang=Talossan
tzm lang=Central
tzn lang=Tugun
tzo lang=Tzotzil
tzx lang=Tabriak
uam lang=Uamué
uan lang=Kuan
uar lang=Tairuma
uba lang=Ubang
ubi lang=Ubi
ubl lang=Buhi'non
ubr lang=Ubir
ubu lang=Umbu-Ungu
uby lang=Ubykh
uda lang=Uda
ude lang=Udihe
udg lang=Muduga
udi lang=Udi
udj lang=Ujir
udl lang=Uldeme
udm lang=Udmurt
udu lang=Uduk
ues lang=Kioko
ufi lang=Ufim
uga lang=Ugaritic
ugb lang=Kuku-Ugbanh
uge lang=Ughele
ugn lang=Ugandan
ugo lang=Gong
ugy lang=Uruguayan
uha lang=Uhami
uhn lang=Damal
uis lang=Uisai
uiv lang=Iyive
uji lang=Tanjijili
uka lang=Kaburi
ukg lang=Ukuriguma
ukh lang=Ukhwejo
ukk lang=Muak
ukl lang=Ukrainian
ukp lang=Ukpe-Bayobiri
ukq lang=Ukwa
uks lang=Kaapor
uku lang=Ukue
ukw lang=Ukwuani-Aboh-Ndoni
uky lang=Kuuk
ula lang=Fungwa
ulb lang=Olukumi
ulc lang=Ulch
ule lang=Lule
ulf lang=Afra
uli lang=Ulithian
ulk lang=Meriam
ull lang=Ullatan
ulm lang=Ulumanda'
uln lang=Unserdeutsch
ulu lang=Uma'
ulw lang=Ulwa
uma lang=Umatilla
umb lang=Umbundu
umc lang=Marrucinian
umd lang=Umbindhamu
umg lang=Umbuygamu
umi lang=Ukit
umm lang=Umon
umn lang=Makyan
umo lang=Umotína
ump lang=Umpila
umr lang=Umbugarla
ums lang=Pendau
umu lang=Munsee
una lang=North
und lang=Undetermined
une lang=Uneme
ung lang=Ngarinyin
unk lang=Enawené-Nawé
unm lang=Unami
unn lang=Kurnai
unr lang=Mundari
unu lang=Unubahe
unx lang=Munda
unz lang=Unde
uok lang=Uokha
uon lang=Kulon
upi lang=Umeda
upv lang=Uripiv-Wala-Rano-Atchin
ura lang=Urarina
urb lang=Urubú-Kaapor
urc lang=Urningangg
ure lang=Uru
urf lang=Uradhi
urg lang=Urigina
urh lang=Urhobo
uri lang=Urim
urk lang=Urak
url lang=Urali
urm lang=Urapmin
urn lang=Uruangnirin
uro lang=Ura
urp lang=Uru-Pa-In
urr lang=Lehalurup
urt lang=Urat
uru lang=Urumi
urv lang=Uruava
urw lang=Sop
urx lang=Urimo
ury lang=Orya
urz lang=Uru-Eu-Wau-Wau
usa lang=Usarufa
ush lang=Ushojo
usi lang=Usui
usk lang=Usaghade
usp lang=Uspanteco
uss lang=Saare
usu lang=Uya
uta lang=Otank
ute lang=Ute
uth lang=Hun
utp lang=Aba
utr lang=Etulo
utu lang=Utu
uum lang=Urum
uun lang=Kulon-Pazeh
uur lang=Ura
uuu lang=U
uve lang=West
uvh lang=Uri
uvl lang=Lote
uwa lang=Kuku-Uwanh
uya lang=Doko-Uyanga
vaa lang=Vaagri
vae lang=Vale
vag lang=Vagla
vah lang=Varhadi
vai lang=Vai
vaj lang=Sekele
val lang=Vehes
vam lang=Vanimo
van lang=Valman
vao lang=Vao
vap lang=Vaiphei
var lang=Huarijio
vas lang=Vasavi
vau lang=Vanuma
vav lang=Varli
vay lang=Vayu
vbb lang=Southeast
vbk lang=Southwestern
vec lang=Venetian
ved lang=Veddah
vem lang=Vemgo-Mabas
veo lang=Ventureño
vep lang=Veps
ver lang=Mom
vgr lang=Vaghri
vgt lang=Flemish
vic lang=Virgin
vid lang=Vidunda
vif lang=Vili
vig lang=Viemo
vil lang=Vilela
vis lang=Vishavan
vit lang=Viti
viv lang=Iduna
vka lang=Kariyarra
vki lang=Ija-Zuba
vkj lang=Kujarge
vkk lang=Kaur
vkl lang=Kulisusu
vkm lang=Kamakan
vko lang=Kodeoha
vkp lang=Korlai
vkt lang=Tenggarong
vku lang=Kurrama
vlp lang=Valpei
vls lang=West
vma lang=Martuthunira
vmb lang=Mbabaram
vmc lang=Juxtlahuaca
vmd lang=Mudu
vme lang=East
vmf lang=East
vmg lang=Minigir
vmh lang=Maraghei
vmi lang=Miwa
vmj lang=Ixtayutla
vmk lang=Makhuwa-Shirima
vml lang=Malgana
vmm lang=Mitlatongo
vmp lang=Soyaltepec
vmq lang=Soyaltepec
vmr lang=Marenje
vmu lang=Muluridyi
vmv lang=Valley
vmw lang=Makhuwa
vmx lang=Tamazola
vmy lang=Ayautla
vmz lang=Mazatlán
vnk lang=Lovono
vnm lang=Neve'ei
vnp lang=Vunapu
vor lang=Voro
vot lang=Votic
vra lang=Vera'a
vro lang=Võro
vrs lang=Varisi
vrt lang=Banam
vsi lang=Moldova
vsl lang=Venezuelan
vsv lang=Valencian
vto lang=Vitou
vum lang=Vumbu
vun lang=Vunjo
vut lang=Vute
vwa lang=Awa
waa lang=Walla
wab lang=Wab
wac lang=Wasco-Wishram
wad lang=Wandamen
waf lang=Wakoná
wag lang=Wa'ema
wah lang=Watubela
waj lang=Waffa
wal lang=Wolaytta
wam lang=Massachusett
wan lang=Wan
wao lang=Wappo
wap lang=Wapishana
waq lang=Wageman
war lang=Waray-Waray
was lang=Washo
wat lang=Kaninuwa
wau lang=Wauja
wav lang=Waka
waw lang=Waiwai
wax lang=Watam
way lang=Wayana
waz lang=Wampur
wba lang=Warao
wbb lang=Wabo
wbe lang=Waritai
wbf lang=Wara
wbh lang=Wanda
wbi lang=Wanji
wbj lang=Alagwa
wbk lang=Waigali
wbl lang=Wakhi
wbm lang=Wa
wbp lang=Warlpiri
wbq lang=Waddar
wbr lang=Wagdi
wbt lang=Wanman
wbv lang=Wajarri
wbw lang=Woi
wca lang=Yanomámi
wci lang=Waci
wdd lang=Wandji
wdg lang=Wadaginam
wdj lang=Wadjiginy
wdt lang=Wendat
wdu lang=Wadjigu
wdy lang=Wadjabangayi
wea lang=Wewaw
wec lang=Wè
wed lang=Wedau
weh lang=Weh
wei lang=Kiunum
wem lang=Weme
weo lang=Wemale
wer lang=Weri
wes lang=Cameroon
wet lang=Perai
weu lang=Welaung
wew lang=Weyewa
wfg lang=Yafi
wga lang=Wagaya
wgb lang=Wagawaga
wgg lang=Wangganguru
wgi lang=Wahgi
wgo lang=Waigeo
wgu lang=Wirangu
wgy lang=Warrgamay
wha lang=Manusela
whg lang=North
whk lang=Wahau
whu lang=Wahau
wib lang=Southern
wic lang=Wichita
wie lang=Wik-Epa
wif lang=Wik-Keyangan
wig lang=Wik-Ngathana
wih lang=Wik-Me'anha
wii lang=Minidien
wij lang=Wik-Iiyanh
wik lang=Wikalkan
wil lang=Wilawila
wim lang=Wik-Mungkan
win lang=Winnebago
wir lang=Wiraféd
wiu lang=Wiru
wiv lang=Muduapa
wiy lang=Wiyot
wja lang=Waja
wji lang=Warji
wka lang=Kw'adza
wkb lang=Kumbaran
wkd lang=Mo
wkl lang=Kalanadi
wku lang=Kunduvadi
wkw lang=Wakawaka
wky lang=Wangkayutyuru
wla lang=Walio
wlc lang=Mwali
wle lang=Wolane
wlg lang=Kunbarlang
wli lang=Waioli
wlk lang=Wailaki
wll lang=Wali
wlm lang=Middle
wlo lang=Wolio
wlr lang=Wailapa
wls lang=Wallisian
wlu lang=Wuliwuli
wlv lang=Wichí
wlw lang=Walak
wlx lang=Wali
wly lang=Waling
wmb lang=Wambaya
wmc lang=Wamas
wmd lang=Mamaindé
wme lang=Wambule
wmh lang=Waima'a
wmi lang=Wamin
wmm lang=Maiwa
wmn lang=Waamwang
wmo lang=Wam
wms lang=Wambon
wmt lang=Walmajarri
wmw lang=Mwani
wmx lang=Womo
wnb lang=Wanambre
wnc lang=Wantoat
wnd lang=Wandarang
wne lang=Waneci
wng lang=Wanggom
wni lang=Ndzwani
wnk lang=Wanukaka
wnm lang=Wanggamala
wno lang=Wano
wnp lang=Wanap
wnu lang=Usan
wnw lang=Wintu
wny lang=Wanyi
woa lang=Tyaraity
wob lang=Wè
woc lang=Wogeo
wod lang=Wolani
woe lang=Woleaian
wog lang=Wogamusin
woi lang=Kamang
wok lang=Longto
wom lang=Perema
won lang=Wongo
woo lang=Manombai
wor lang=Woria
wos lang=Hanga
wow lang=Wawonii
wpc lang=Wirö
wra lang=Warapu
wrb lang=Warluwara
wrg lang=Warungu
wrh lang=Wiradhuri
wri lang=Wariyangga
wrk lang=Garawa
wrl lang=Warlmanpa
wrm lang=Warumungu
wrn lang=Warnang
wro lang=Worora
wrp lang=Waropen
wrr lang=Wardaman
wrs lang=Waris
wru lang=Waru
wrv lang=Waruna
wrw lang=Gugu
wrx lang=Wae
wrz lang=Warray
wsa lang=Warembori
wsi lang=Wusi
wsk lang=Waskia
wsr lang=Owenia
wss lang=Wasa
wsu lang=Wasu
wsv lang=Wotapuri-Katarqalai
wtf lang=Watiwa
wth lang=Wathaurong
wti lang=Berta
wtk lang=Watakataui
wtm lang=Mewati
wtw lang=Wotu
wua lang=Wikngenchera
wub lang=Wunambal
wud lang=Wudu
wuh lang=Wutunhua
wul lang=Silimo
wum lang=Wumbvu
wun lang=Bungu
wur lang=Wurrugu
wut lang=Wutung
wuu lang=Wu
wuv lang=Wuvulu-Aua
wux lang=Wulna
wuy lang=Wauyai
wwa lang=Waama
wwo lang=Dorig
wwr lang=Warrwa
www lang=Wawa
wxa lang=Waxianghua
wxw lang=Wardandi
wya lang=Wyandot
wyb lang=Ngiyambaa
wyi lang=Woiwurrung
wym lang=Vilamovian
wyr lang=Wayoró
wyy lang=Western
xaa lang=Andalusian
xab lang=Sambe
xac lang=Kachari
xad lang=Adai
xae lang=Aequian
xag lang=Aghwan
xai lang=Kaimbé
xaj lang=Ararandewára
xak lang=Maku
xal lang=Kalmyk
xam lang=ǀXam
xan lang=Xamtanga
xao lang=Khao
xap lang=Apalachee
xaq lang=Aquitanian
xar lang=Karami
xas lang=Kamassian
xat lang=Katawixi
xau lang=Kauwera
xav lang=Xavante
xaw lang=Kawaiisu
xay lang=Kayan
xbb lang=Lower
xbc lang=Bactrian
xbd lang=Bindal
xbe lang=Bigambal
xbg lang=Bunganditj
xbi lang=Kombio
xbj lang=Birrpayi
xbm lang=Middle
xbn lang=Kenaboi
xbo lang=Bulgar
xbp lang=Bibbulman
xbr lang=Kambera
xbw lang=Kambiwá
xby lang=Butchulla
xcb lang=Cumbric
xcc lang=Camunic
xce lang=Celtiberian
xch lang=Chemakum
xcl lang=Old
xcm lang=Comecrudo
xcn lang=Cotoname
xco lang=Khwarezmian
xcr lang=Carian
xct lang=Classical
xcu lang=Curonian
xcv lang=Chuvan
xcw lang=Coahuilteco
xcy lang=Cayuse
xda lang=Darkinjung
xdc lang=Dacian
xdk lang=Dharug
xdm lang=Edomite
xdy lang=Malayic
xeb lang=Eblaite
xed lang=Hdi
xeg lang=ǁXegwi
xel lang=Kelo
xem lang=Kembayan
xep lang=Epi-Olmec
xer lang=Xerénte
xes lang=Kesawai
xet lang=Xetá
xeu lang=Keoru-Ahia
xfa lang=Faliscan
xga lang=Galatian
xgb lang=Gbin
xgd lang=Gudang
xgf lang=Gabrielino-Fernandeño
xgg lang=Goreng
xgi lang=Garingbal
xgl lang=Galindan
xgm lang=Darumbal
xgr lang=Garza
xgu lang=Unggumi
xgw lang=Guwa
xha lang=Harami
xhc lang=Hunnic
xhd lang=Hadrami
xhe lang=Khetrani
xhm lang=Middle
xhr lang=Hernican
xht lang=Hattic
xhu lang=Hurrian
xhv lang=Khua
xib lang=Iberian
xii lang=Xiri
xil lang=Illyrian
xin lang=Xinca
xir lang=Xiriâna
xis lang=Kisan
xiv lang=Indus
xiy lang=Xipaya
xjb lang=Minjungbal
xka lang=Kalkoti
xkb lang=Manigri-Kambolé
xkc lang=Khoini
xkd lang=Mendalam
xke lang=Kereho
xkf lang=Khengkha
xkg lang=Kagoro
xki lang=Kenyan
xkj lang=Kajali
xkk lang=Kaco'
xkl lang=Bakung
xkn lang=Kayan
xko lang=Kiorr
xkp lang=Kabatei
xkq lang=Koroni
xkr lang=Xakriabá
xks lang=Kumbewaha
xkt lang=Kantosi
xku lang=Kaamba
xkv lang=Kgalagadi
xkw lang=Kembra
xkx lang=Karore
xky lang=Uma'
xkz lang=Kurtop
xla lang=Kamula
xlb lang=Loup
xlc lang=Lycian
xld lang=Lydian
xle lang=Lemnian
xlg lang=Ancient
xli lang=Liburnian
xlo lang=Loup
xlp lang=Lepontic
xls lang=Lusitanian
xlu lang=Luwian
xly lang=Elymian
xmb lang=Mbonga
xmc lang=Makhuwa-Marrevone
xmd lang=Mbudum
xmf lang=Mingrelian
xmg lang=Mengaka
xmh lang=Kugu-Muminh
xmj lang=Majera
xmk lang=Ancient
xml lang=Malaysian
xmm lang=Manado
xmo lang=Morerebi
xmp lang=Kuku-Mu'inh
xmq lang=Kuku-Mangk
xmr lang=Meroitic
xms lang=Moroccan
xmt lang=Matbat
xmu lang=Kamu
xmx lang=Maden
xmy lang=Mayaguduna
xmz lang=Mori
xna lang=Ancient
xnb lang=Kanakanabu
xng lang=Middle
xnh lang=Kuanhua
xni lang=Ngarigu
xnk lang=Nganakarti
xnn lang=Northern
xnr lang=Kangri
xns lang=Kanashi
xnt lang=Narragansett
xnu lang=Nukunul
xny lang=Nyiyaparli
xoc lang=O'chi'chi'
xod lang=Kokoda
xog lang=Soga
xoi lang=Kominimung
xok lang=Xokleng
xom lang=Komo
xon lang=Konkomba
xoo lang=Xukurú
xop lang=Kopar
xor lang=Korubo
xow lang=Kowaki
xpa lang=Pirriya
xpb lang=Pyemmairre
xpc lang=Pecheneg
xpd lang=Paredarerme
xpe lang=Liberia
xpf lang=Southeast
xpg lang=Phrygian
xph lang=Tyerrernotepanner
xpi lang=Pictish
xpj lang=Mpalitjanh
xpk lang=Kulina
xpl lang=Port
xpm lang=Pumpokol
xpn lang=Kapinawá
xpo lang=Pochutec
xpp lang=Puyo-Paekche
xpq lang=Mohegan-Pequot
xpr lang=Parthian
xps lang=Pisidian
xpu lang=Punic
xpv lang=Tommeginne
xpw lang=Peerapper
xpx lang=Toogee
xpy lang=Buyeo
xpz lang=Bruny
xqa lang=Karakhanid
xqt lang=Qatabanian
xra lang=Krahô
xrb lang=Eastern
xrd lang=Gundungurra
xre lang=Kreye
xrg lang=Minang
xri lang=Krikati-Timbira
xrm lang=Armazic
xrn lang=Arin
xrq lang=Karranga
xrr lang=Raetic
xrt lang=Aranama-Tamique
xru lang=Marriammu
xrw lang=Karawa
xsa lang=Sabaean
xsb lang=Sambali
xsd lang=Sidetic
xse lang=Sempan
xsh lang=Shamang
xsi lang=Sio
xsj lang=Subi
xsl lang=South
xsm lang=Kasem
xsn lang=Sanga
xso lang=Solano
xsp lang=Silopi
xsq lang=Makhuwa-Saka
xsr lang=Sherpa
xss lang=Assan
xsu lang=Sanumá
xsv lang=Sudovian
xsy lang=Saisiyat
xta lang=Alcozauca
xtb lang=Chazumba
xtc lang=Kadugli
xtd lang=Diuxi-Tilantongo
xte lang=Ketengban
xth lang=Yitha
xti lang=Sinicahua
xtj lang=San
xtl lang=Tijaltepec
xtm lang=Magdalena
xtn lang=Northern
xto lang=Tocharian
xtp lang=San
xtq lang=Tumshuqese
xtr lang=Early
xts lang=Sindihui
xtt lang=Tacahua
xtu lang=Cuyamecalco
xtv lang=Thawa
xtw lang=Tawandê
xty lang=Yoloxochitl
xtz lang=Tasmanian
xua lang=Alu
xub lang=Betta
xud lang=Umiida
xug lang=Kunigami
xuj lang=Jennu
xul lang=Ngunawal
xum lang=Umbrian
xun lang=Unggaranggu
xuo lang=Kuo
xup lang=Upper
xur lang=Urartian
xut lang=Kuthant
xuu lang=Khwe
xve lang=Venetic
xvn lang=Vandalic
xvo lang=Volscian
xvs lang=Vestinian
xwa lang=Kwaza
xwc lang=Woccon
xwd lang=Wadi
xwe lang=Xwela
xwg lang=Kwegu
xwj lang=Wajuk
xwk lang=Wangkumara
xwl lang=Western
xwo lang=Written
xwr lang=Kwerba
xww lang=Wemba-Wemba
xxb lang=Boro
xxk lang=Ke'o
xxm lang=Minkin
xxr lang=Koropó
xxt lang=Tambora
xya lang=Yaygir
xyb lang=Yandjibara
xyl lang=Yalakalore
xyt lang=Mayi-Thakurti
xyy lang=Yorta
xzh lang=Zhang-Zhung
xzm lang=Zemgalian
xzp lang=Ancient
yaa lang=Yaminahua
yab lang=Yuhup
yac lang=Pass
yad lang=Yagua
yae lang=Pumé
yaf lang=Yaka
yag lang=Yámana
yah lang=Yazghulami
yai lang=Yagnobi
yaj lang=Banda-Yangere
yak lang=Yakima
yal lang=Yalunka
yam lang=Yamba
yan lang=Mayangna
yao lang=Yao
yap lang=Yapese
yaq lang=Yaqui
yar lang=Yabarana
yas lang=Gunu
yat lang=Yambeta
yau lang=Yuwana
yav lang=Yangben
yaw lang=Yawalapití
yay lang=Agwagwune
yaz lang=Lokaa
yba lang=Yala
ybb lang=Yemba
ybe lang=Western
ybh lang=Yakkha
ybi lang=Yamphu
ybj lang=Hasha
ybk lang=Bokha
ybl lang=Yukuben
ybm lang=Yaben
ybn lang=Yabaâna
ybo lang=Yabong
ybx lang=Yawiyo
yby lang=Yaweyuha
ych lang=Chesu
ycl lang=Lolopo
ycn lang=Yucuna
ycp lang=Chepya
yda lang=Yanda
yde lang=Yangum
ydg lang=Yidgha
ydk lang=Yoidik
yea lang=Ravula
yec lang=Yeniche
yee lang=Yimas
yei lang=Yeni
yej lang=Yevanic
yen lang=Yendang
yer lang=Tarok
yes lang=Yeskwa
yet lang=Yetfa
yeu lang=Yerukula
yev lang=Yapunda
yey lang=Yeyi
ygi lang=Yiningayi
ygl lang=Yangum
ygm lang=Yagomi
ygp lang=Gepo
ygr lang=Yagaria
ygs lang=Yolngu
ygu lang=Yugul
ygw lang=Yagwoia
yha lang=Baha
yhl lang=Hlepho
yia lang=Yinggarda
yif lang=Ache
yig lang=Wusa
yii lang=Yidiny
yij lang=Yindjibarndi
yik lang=Dongshanba
yil lang=Yindjilandji
yim lang=Yimchungru
yin lang=Yinchia
yip lang=Pholo
yiq lang=Miqie
yir lang=North
yis lang=Yis
yit lang=Eastern
yiu lang=Awu
yiv lang=Northern
yix lang=Axi
yiy lang=Yir-Yoront
yiz lang=Azhe
yka lang=Yakan
ykg lang=Northern
yki lang=Yoke
ykk lang=Yakaikeke
ykl lang=Khlula
ykm lang=Kap
ykn lang=Kua-nsi
yko lang=Yasa
ykr lang=Yekora
ykt lang=Kathu
yku lang=Kuamasi
yky lang=Yakoma
yla lang=Yaul
ylb lang=Yaleba
yle lang=Yele
ylg lang=Yelogu
yli lang=Angguruk
yll lang=Yil
ylm lang=Limi
yln lang=Langnian
ylo lang=Naluo
ylr lang=Yalarnnga
ylu lang=Aribwaung
yly lang=Nyâlayu
ymb lang=Yambes
ymc lang=Southern
ymd lang=Muda
yme lang=Yameo
ymg lang=Yamongeri
ymh lang=Mili
ymi lang=Moji
ymk lang=Makwe
yml lang=Iamalele
ymm lang=Maay
ymn lang=Sunum
ymo lang=Yangum
ymp lang=Yamap
ymq lang=Qila
ymr lang=Malasar
yms lang=Mysian
ymx lang=Northern
ymz lang=Muzi
yna lang=Aluo
ynd lang=Yandruwandha
yne lang=Lang'e
yng lang=Yango
ynk lang=Naukanski
ynl lang=Yangulam
ynn lang=Yana
yno lang=Yong
yns lang=Yansi
ynu lang=Yahuna
yob lang=Yoba
yog lang=Yogad
yoi lang=Yonaguni
yol lang=Yola
yom lang=Yombe
yon lang=Yongkom
yox lang=Yoron
yoy lang=Yoy
ypa lang=Phala
ypb lang=Labo
ypg lang=Phola
yph lang=Phupha
ypm lang=Phuma
ypn lang=Ani
ypo lang=Alo
ypp lang=Phupa
ypz lang=Phuza
yra lang=Yerakai
yrb lang=Yareba
yre lang=Yaouré
yri lang=Yarí
yrk lang=Tundra
yrl lang=Nheengatu
yrn lang=Yerong
yro lang=Yaroamë
yrw lang=Yarawata
yry lang=Yarluyandi
ysc lang=Jassic
ysd lang=Samatao
ysg lang=Sonaga
ysl lang=Yugoslavian
ysn lang=Sani
yso lang=Nisi
ysp lang=Southern
ysr lang=Sirenik
yss lang=Yessan-Mayo
ysy lang=Sanie
yta lang=Talu
ytl lang=Tanglang
ytp lang=Thopho
ytw lang=Yout
yty lang=Yatay
yua lang=Yucatec
yub lang=Yugambal
yuc lang=Yuchi
yue lang=Cantonese
yuf lang=Havasupai-Walapai-Yavapai
yug lang=Yug
yui lang=Yurutí
yuj lang=Karkar-Yuri
yuk lang=Yuki
yul lang=Yulu
yum lang=Yuma
yun lang=Bena
yup lang=Yukpa
yuq lang=Yuqui
yur lang=Yurok
yut lang=Yopno
yuw lang=Finisterre
yux lang=Southern
yuy lang=East
yuz lang=Yuracare
yva lang=Yawa
yvt lang=Yavitero
ywa lang=Kalou
ywg lang=Yinhawangka
ywl lang=Western
ywn lang=Yawanawa
ywq lang=Nasu
ywr lang=Yawuru
ywt lang=Xishanba
ywu lang=Wumeng
yww lang=Yawarawarga
yxa lang=Mayawali
yxg lang=Yagara
yxl lang=Yarli
yxm lang=Yinwum
yxu lang=Yuyu
yxy lang=Yabula
yyu lang=Torricelli
yyz lang=Ayizi
yzg lang=E'ma
yzk lang=Zokhuo
zaa lang=Sierra
zab lang=San
zac lang=Ocotlán
zad lang=Cajonos
zae lang=Yareni
zaf lang=Ayoquesco
zag lang=Zaghawa
zah lang=Zangwal
zai lang=Isthmus
zaj lang=Zaramo
zak lang=Zanaki
zal lang=Zauzou
zam lang=Central
zao lang=Ozolotepec
zap lang=Zapotec
zaq lang=Aloápam
zar lang=Rincón
zas lang=Santo
zat lang=Tabaa
zau lang=Zangskari
zav lang=Yatzachi
zaw lang=Mitla
zax lang=Xadani
zay lang=Zayse-Zergulla
zaz lang=Zari
zbt lang=Batui
zca lang=Coatecas
zdj lang=Ngazidja
zea lang=Zealandic
zeg lang=Zenag
zen lang=Zenaga
zga lang=Kinga
zgh lang=Moroccan
zgr lang=Magori
zhb lang=Zhaba
zhi lang=Zhire
zhn lang=Nong
zhw lang=Zhoa
zia lang=Zia
zib lang=Zimbabwe
zik lang=Zimakani
zil lang=Zialo
zim lang=Mesme
zin lang=Zinza
zir lang=Ziriya
ziw lang=Zigula
ziz lang=Zizilivakan
zka lang=Kaimbulawa
zkb lang=Koibal
zkg lang=Goguryeo
zkh lang=Khorezmian
zkk lang=Karankawa
zko lang=Kott
zkp lang=São
zkr lang=Zakhring
zkt lang=Khitan
zku lang=Kaurna
zkv lang=Krevinian
zkz lang=Khazar
zma lang=Manda
zmb lang=Zimba
zmc lang=Margany
zmd lang=Maridan
zme lang=Mangerr
zmf lang=Mfinu
zmg lang=Marti
zmh lang=Makolkol
zmi lang=Negeri
zmj lang=Maridjabin
zmk lang=Mandandanyi
zml lang=Madngele
zmm lang=Marimanindji
zmn lang=Mbangwe
zmo lang=Molo
zmp lang=Mbuun
zmq lang=Mituku
zmr lang=Maranungku
zms lang=Mbesa
zmt lang=Maringarr
zmu lang=Muruwari
zmv lang=Mbariman-Gudhinma
zmw lang=Mbo
zmx lang=Bomitaba
zmy lang=Mariyedi
zmz lang=Mbandja
zna lang=Zan
zne lang=Zande
zng lang=Mang
znk lang=Manangkari
zns lang=Mangas
zoc lang=Copainalá
zoh lang=Chimalapa
zom lang=Zou
zoo lang=Asunción
zoq lang=Tabasco
zor lang=Rayón
zos lang=Francisco
zpa lang=Lachiguiri
zpb lang=Yautepec
zpc lang=Choapan
zpd lang=Southeastern
zpe lang=Petapa
zpf lang=San
zpg lang=Guevea
zph lang=Totomachapan
zpi lang=Santa
zpj lang=Quiavicuzas
zpk lang=Tlacolulita
zpl lang=Lachixío
zpm lang=Mixtepec
zpn lang=Santa
zpo lang=Amatlán
zpp lang=El
zpq lang=Zoogocho
zpr lang=Santiago
zps lang=Coatlán
zpt lang=San
zpu lang=Yalálag
zpv lang=Chichicapan
zpw lang=Zaniza
zpx lang=San
zpy lang=Mazaltepec
zpz lang=Texmelucan
zra lang=Kaya
zrg lang=Mirgan
zrn lang=Zirenkel
zro lang=Záparo
zrs lang=Mairasi
zsa lang=Sarasira
zsk lang=Kaskean
zsl lang=Zambian
zsr lang=Southern
zsu lang=Sukurum
zte lang=Elotepec
ztg lang=Xanaguía
ztl lang=Lapaguía-Guivini
ztm lang=San
ztn lang=Santa
ztp lang=Loxicha
ztq lang=Quioquitani-Quierí
zts lang=Tilquiapan
ztt lang=Tejalapan
ztu lang=San
ztx lang=Zaachila
zty lang=Yatee
zua lang=Zeem
zuh lang=Tokano
zum lang=Kumzari
zun lang=Zuni
zuy lang=Zumaya
zwa lang=Zay
zyp lang=Zyphe
zza lang=Zazaki
zzj lang=Zuojiang
Code lang=Canonical
aav - khs - pro lang=Proto-Khasian
aav - nic - pro lang=Proto-Nicobarese
aav - pkl - pro lang=Proto-Pnar-Khasi-Lyngngam
aav - pro lang=Proto-Austroasiatic
afa - pro lang=Proto-Afroasiatic
alg - aga lang=Agawam
alg - pro lang=Proto-Algonquian
alv - ama lang=Amasi
alv - bgu lang=Baïnounk
alv - bua - pro lang=Proto-Bua
alv - cng - pro lang=Proto-Cangin
alv - edo - pro lang=Proto-Edoid
alv - fli - pro lang=Proto-Fali
alv - gbe - pro lang=Proto-Gbe
alv - gng - pro lang=Proto-Guang
alv - gtm - pro lang=Proto-Central
alv - gwa lang=Gwara
alv - hei - pro lang=Proto-Heiban
alv - ido - pro lang=Proto-Idomoid
alv - igb - pro lang=Proto-Igboid
alv - kwa - pro lang=Proto-Kwa
alv - mum - pro lang=Proto-Mumuye
alv - nup - pro lang=Proto-Nupoid
alv - pro lang=Proto-Atlantic-Congo
alv - von - pro lang=Proto-Volta-Niger
alv - yor - pro lang=Proto-Yoruboid
apa - pro lang=Proto-Apachean
aql - pro lang=Proto-Algic
art - blk lang=Bolak
art - bsp lang=Black
art - com lang=Communicationssprache
art - dtk lang=Dothraki
art - elo lang=Eloi
art - gld lang=Goa'uld
art - lap lang=Lapine
art - man lang=Mandalorian
art - mun lang=Mundolinco
art - nav lang=Na'vi
art - nox lang=Noxilo
art - una lang=Unas
ath - nic lang=Nicola
ath - pro lang=Proto-Athabaskan
auf - pro lang=Proto-Arawa
aus - alu lang=Alungul
aus - and lang=Andjingith
aus - ang lang=Angkula
aus - arn - pro lang=Proto-Arnhem
aus - bra lang=Barranbinya
aus - brm lang=Barunggam
aus - cww - pro lang=Proto-Central
aus - dal - pro lang=Proto-Daly
aus - guw lang=Guwar
aus - lsw lang=Little
aus - mbi lang=Mbiywom
aus - ngk lang=Ngkoth
aus - nyu - pro lang=Proto-Nyulnyulan
aus - pam - pro lang=Proto-Pama-Nyungan
aus - tul lang=Tulua
aus - uwi lang=Uwinymil
aus - wdj - pro lang=Proto-Iwaidjan
aus - won lang=Wong-gie
aus - wul lang=Wulguru
aus - ynk lang=Yangkaal
awd - ama lang=Amarizana
awd - amc - pro lang=Proto-Amuesha-Chamicuro
awd - ana lang=Anauyá
awd - apo lang=Apolista
awd - cav lang=Cavere
awd - gnu lang=Guinau
awd - kar lang=Cariay
awd - kaw lang=Kawishana
awd - kmp - pro lang=Proto-Kampa
awd - kus lang=Kustenau
awd - man lang=Manao
awd - mar lang=Marawan
awd - mpr lang=Maypure
awd - mrt lang=Mariaté
awd - nwk - pro lang=Proto-Nawiki
awd - pai lang=Paikoneka
awd - pas lang=Passé
awd - pro lang=Proto-Arawak
awd - prw - pro lang=Proto-Paresi-Waura
awd - she lang=Shebayo
awd - taa - pro lang=Proto-Ta-Arawak
awd - wai lang=Wainumá
awd - yum lang=Yumana
azc - caz lang=Cazcan
azc - cup - pro lang=Proto-Cupan
azc - ktn lang=Kitanemuk
azc - nah - pro lang=Proto-Nahuan
azc - num - pro lang=Proto-Numic
azc - pro lang=Proto-Uto-Aztecan
azc - tak - pro lang=Proto-Takic
azc - tat lang=Tataviam
ber - fog lang=Fogaha
ber - pro lang=Proto-Berber
ber - zuw lang=Zuwara
bnt - bal lang=Balong
bnt - bon lang=Boma
bnt - boy lang=Boma
bnt - bwa lang=Bwala
bnt - cmw lang=Chimwiini
bnt - ind lang=Indanga
bnt - lal lang=Lala
bnt - lwl lang=Lwel
bnt - mpi lang=Mpiin
bnt - mpu lang=Mpuono
bnt - ngu - pro lang=Proto-Nguni
bnt - phu lang=Phuthi
bnt - pro lang=Proto-Bantu
bnt - sbo lang=South
bnt - sts - pro lang=Proto-Sotho-Tswana
btk - pro lang=Proto-Batak
cau - abz - pro lang=Proto-Abkhaz-Abaza
cau - ava - pro lang=Proto-Avaro-Andian
cau - cir - pro lang=Proto-Circassian
cau - drg - pro lang=Proto-Dargwa
cau - lzg - pro lang=Proto-Lezghian
cau - nec - pro lang=Proto-Northeast
cau - nkh - pro lang=Proto-Nakh
cau - nwc - pro lang=Proto-Northwest
cau - tsz - pro lang=Proto-Tsezian
cba - ata lang=Atanques
cba - cat lang=Catío
cba - dor lang=Dorasque
cba - dui lang=Duit
cba - hue lang=Huetar
cba - nut lang=Nutabe
cba - pro lang=Proto-Chibchan
ccn - pro lang=Proto-North
ccs - gzn - pro lang=Proto-Georgian-Zan
ccs - pro lang=Proto-Kartvelian
cdc - cbm - pro lang=Proto-Central
cdc - mas - pro lang=Proto-Masa
cdc - pro lang=Proto-Chadic
cdd - pro lang=Proto-Caddoan
cel - bry - pro lang=Proto-Brythonic
cel - gal lang=Gallaecian
cel - gau lang=Gaulish
cel - pro lang=Proto-Celtic
chi - pro lang=Proto-Chimakuan
cmc - pro lang=Proto-Chamic
cpe - mar lang=Maroon
cpe - spp lang=Samoan
crp - gep lang=West
crp - mpp lang=Macau
crp - rsn lang=Russenorsk
crp - tpr lang=Taimyr
csu - bba - pro lang=Proto-Bongo-Bagirmi
csu - maa - pro lang=Proto-Mangbetu
csu - pro lang=Proto-Central
csu - sar - pro lang=Proto-Sara
ctp - san lang=San
cus - ash lang=Ashraaf
cus - hec - pro lang=Proto-Highland
cus - pro lang=Proto-Cushitic
dmn - dam lang=Dama
dmn - mdw - pro lang=Proto-Western
dmn - pro lang=Proto-Mande
dra - mkn lang=Middle
dra - okn lang=Old
dra - pro lang=Proto-Dravidian
dru - pro lang=Proto-Rukai
egx - dem lang=Demotic
elu - prk lang=Helu
esx - esk - pro lang=Proto-Eskimo
esx - ink lang=Inuktun
esx - inq lang=Inuinnaqtun
esx - inu - pro lang=Proto-Inuit
esx - pro lang=Proto-Eskimo-Aleut
esx - tut lang=Tunumiisut
euq - pro lang=Proto-Basque
fiu - fin - pro lang=Proto-Finnic
gem - bur lang=Burgundian
gem - pro lang=Proto-Germanic
gme - cgo lang=Crimean
gmq - bot lang=Westrobothnian
gmq - gut lang=Gutnish
gmq - jmk lang=Jamtish
gmq - mno lang=Middle
gmq - oda lang=Old
gmq - osw lang=Old
gmq - pro lang=Proto-Norse
gmq - scy lang=Scanian
gmw - bgh lang=Bergish
gmw - cfr lang=Central
gmw - ecg lang=East
gmw - gts lang=Gottscheerish
gmw - jdt lang=Jersey
gmw - pro lang=Proto-West
gmw - rfr lang=Rhine
gmw - stm lang=Sathmar
gmw - tsx lang=Transylvanian
gmw - vog lang=Volga
gmw - zps lang=Zipser
gn - cls lang=Classical
grk - cal lang=Calabrian
grk - ita lang=Italiot
grk - mar lang=Mariupol
grk - pro lang=Proto-Hellenic
hmn - pro lang=Proto-Hmong
hmx - mie - pro lang=Proto-Mien
hmx - pro lang=Proto-Hmong-Mien
hyx - pro lang=Proto-Armenian
iir - nur - pro lang=Proto-Nuristani
iir - pro lang=Proto-Indo-Iranian
ijo - pro lang=Proto-Ijoid
inc - ash lang=Ashokan
inc - cen - pro lang=Proto-Central
inc - gup lang=Gurjar
inc - kam lang=Kamarupi
inc - kha lang=Khasa
inc - kho lang=Kholosi
inc - mas lang=Middle
inc - mbn lang=Middle
inc - mgd lang=Magadhi
inc - mgu lang=Middle
inc - mor lang=Middle
inc - oas lang=Early
inc - obn lang=Old
inc - ogu lang=Old
inc - ohi lang=Old
inc - oor lang=Old
inc - opa lang=Old
inc - ork lang=Old
inc - pra lang=Prakrit
inc - pro lang=Proto-Indo-Aryan
inc - psc lang=Paisaci
inc - sap lang=Sauraseni
inc - tak lang=Takka
inc - vra lang=Vracada
ine - ana - pro lang=Proto-Anatolian
ine - bsl - pro lang=Proto-Balto-Slavic
ine - pae lang=Paeonian
ine - pro lang=Proto-Indo-European
ine - toc - pro lang=Proto-Tocharian
ira - kms - pro lang=Proto-Komisenian
ira - mny - pro lang=Proto-Munji-Yidgha
ira - mpr - pro lang=Proto-Medo-Parthian
ira - pat - pro lang=Proto-Pathan
ira - pro lang=Proto-Iranian
ira - sgc - pro lang=Proto-Sogdic
ira - sgi - pro lang=Proto-Sanglechi-Ishkashimi
ira - shr - pro lang=Proto-Shughni-Roshani
ira - shy - pro lang=Proto-Shughni-Yazghulami
ira - sym - pro lang=Proto-Shughni-Yazghulami-Munji
ira - wnj lang=Vanji
ira - zgr - pro lang=Proto-Zaza-Gorani
iro - ere lang=Erie
iro - min lang=Mingo
iro - nor - pro lang=Proto-North
iro - pro lang=Proto-Iroquoian
itc - pro lang=Proto-Italic
jpx - pro lang=Proto-Japonic
jpx - ryu - pro lang=Proto-Ryukyuan
kar - pro lang=Proto-Karen
khi - kho - pro lang=Proto-Khoe
khi - kun lang=ǃKung
ko - ear lang=Early
kro - pro lang=Proto-Kru
ku - pro lang=Proto-Kurdish
map - ata - pro lang=Proto-Atayalic
map - bms lang=Banyumasan
map - pro lang=Proto-Austronesian
mkh - asl - pro lang=Proto-Aslian
mkh - ban - pro lang=Proto-Bahnaric
mkh - kat - pro lang=Proto-Katuic
mkh - khm - pro lang=Proto-Khmuic
mkh - kmr - pro lang=Proto-Khmeric
mkh - mmn lang=Middle
mkh - mnc - pro lang=Proto-Monic
mkh - mvi lang=Middle
mkh - pal - pro lang=Proto-Palaungic
mkh - pea - pro lang=Proto-Pearic
mkh - pkn - pro lang=Proto-Pakanic
mkh - pro lang=Proto-Mon-Khmer
mkh - vie - pro lang=Proto-Vietic
mnw - tha lang=Thai
mun - pro lang=Proto-Munda
myn - chl lang=Ch'olti'
myn - pro lang=Proto-Mayan
nai - ala lang=Alazapa
nai - bay lang=Bayogoula
nai - bvy lang=Buena
nai - cal lang=Calusa
nai - chi lang=Chiquimulilla
nai - chu - pro lang=Proto-Chumash
nai - cig lang=Ciguayo
nai - ckn - pro lang=Proto-Chinookan
nai - dly lang=Delta
nai - gsy lang=Gashowu
nai - guz lang=Guazacapán
nai - hit lang=Hitchiti
nai - ipa lang=Ipai
nai - jtp lang=Jutiapa
nai - jum lang=Jumaytepeque
nai - kat lang=Kathlamet
nai - klp - pro lang=Proto-Kalapuyan
nai - knm lang=Konomihu
nai - kry lang=Kings
nai - kum lang=Kumeyaay
nai - mac lang=Macoris
nai - mdu - pro lang=Proto-Maidun
nai - miz - pro lang=Proto-Mixe-Zoque
nai - nao lang=Naolan
nai - nrs lang=New
nai - nvy lang=Northern
nai - okw lang=Okwanuchu
nai - per lang=Pericú
nai - pic lang=Picuris
nai - plp - pro lang=Proto-Plateau
nai - ply lang=Palewyami
nai - pom - pro lang=Proto-Pomo
nai - qng lang=Quinigua
nai - sca - pro lang=Proto-Siouan-Catawban
nai - sin lang=Sinacantán
nai - sln lang=Salvadoran
nai - spt lang=Sahaptin
nai - svy lang=Southern
nai - tap lang=Tapachultec
nai - taw lang=Tawasa
nai - teq lang=Tequistlatec
nai - tip lang=Tipai
nai - tky lang=Tule-Kaweah
nai - tot - pro lang=Proto-Totozoquean
nai - tsi - pro lang=Proto-Tsimshianic
nai - utn - pro lang=Proto-Utian
nai - wai lang=Waikuri
nai - yup lang=Yupiltepeque
nds - de lang=German
nds - nl lang=Dutch
ngf - pro lang=Proto-Trans-New
nic - bco - pro lang=Proto-Benue-Congo
nic - bod - pro lang=Proto-Bantoid
nic - eov - pro lang=Proto-Eastern
nic - gns - pro lang=Proto-Gurunsi
nic - grf - pro lang=Proto-Grassfields
nic - gur - pro lang=Proto-Gur
nic - jkn - pro lang=Proto-Jukunoid
nic - lcr - pro lang=Proto-Lower
nic - ogo - pro lang=Proto-Ogoni
nic - ovo - pro lang=Proto-Oti-Volta
nic - plt - pro lang=Proto-Plateau
nic - pro lang=Proto-Niger-Congo
nic - ubg - pro lang=Proto-Ubangian
nic - ucr - pro lang=Proto-Upper
nic - vco - pro lang=Proto-Volta-Congo
nub - har lang=Haraza
nub - pro lang=Proto-Nubian
omq - cha - pro lang=Proto-Chatino
omq - maz - pro lang=Proto-Mazatec
omq - mix - pro lang=Proto-Mixtecan
omq - mxt - pro lang=Proto-Mixtec
omq - otp - pro lang=Proto-Oto-Pamean
omq - pro lang=Proto-Oto-Manguean
omq - tel lang=Teposcolula
omq - teo lang=Teojomulco
omq - tri - pro lang=Proto-Trique
omq - zap - pro lang=Proto-Zapotecan
omq - zpc - pro lang=Proto-Zapotec
omv - aro - pro lang=Proto-Aroid
omv - diz - pro lang=Proto-Dizoid
omv - pro lang=Proto-Omotic
os - pro lang=Proto-Ossetic
oto - otm - pro lang=Proto-Otomi
oto - pro lang=Proto-Otomian
paa - kom lang=Kómnzo
paa - kwn lang=Kuwani
paa - nha - pro lang=Proto-North
paa - nun lang=Nungon
phi - din lang=Dinapigue
phi - kal - pro lang=Proto-Kalamian
phi - nag lang=Nagtipunan
phi - pro lang=Proto-Philippine
poz - abi lang=Abai
poz - bal lang=Baliledo
poz - btk - pro lang=Proto-Bungku-Tolaki
poz - cet - pro lang=Proto-Central-Eastern
poz - hce - pro lang=Proto-Halmahera-Cenderawasih
poz - lgx - pro lang=Proto-Lampungic
poz - mcm - pro lang=Proto-Malayo-Chamic
poz - mly - pro lang=Proto-Malayic
poz - msa - pro lang=Proto-Malayo-Sumbawan
poz - oce - pro lang=Proto-Oceanic
poz - pep - pro lang=Proto-Eastern
poz - pnp - pro lang=Proto-Nuclear
poz - pol - pro lang=Proto-Polynesian
poz - pro lang=Proto-Malayo-Polynesian
poz - ssw - pro lang=Proto-South
poz - sus - pro lang=Proto-Sunda-Sulawesi
poz - swa - pro lang=Proto-North
pqe - pro lang=Proto-Eastern
pra - niy lang=Niya
qfa - adm - pro lang=Proto-Great
qfa - bet - pro lang=Proto-Be-Tai
qfa - cka - pro lang=Proto-Chukotko-Kamchatkan
qfa - hur - pro lang=Proto-Hurro-Urartian
qfa - kad - pro lang=Proto-Kadu
qfa - kms - pro lang=Proto-Kam-Sui
qfa - kor - pro lang=Proto-Koreanic
qfa - kra - pro lang=Proto-Kra
qfa - lic - pro lang=Proto-Hlai
qfa - onb - pro lang=Proto-Be
qfa - ong - pro lang=Proto-Ongan
qfa - tak - pro lang=Proto-Kra-Dai
qfa - yen - pro lang=Proto-Yeniseian
qfa - yuk - pro lang=Proto-Yukaghir
qwe - kch lang=Kichwa
roa - ang lang=Angevin
roa - bbn lang=Bourbonnais-Berrichon
roa - brg lang=Bourguignon
roa - cha lang=Champenois
roa - fcm lang=Franc-Comtois
roa - gal lang=Gallo
roa - leo lang=Leonese
roa - lor lang=Lorrain
roa - oan lang=Navarro-Aragonese
roa - oca lang=Old
roa - ole lang=Old
roa - opt lang=Old
roa - orl lang=Orléanais
roa - poi lang=Poitevin-Saintongeais
roa - tar lang=Tarantino
roa - tou lang=Tourangeau
sai - ajg lang=Ajagua
sai - all lang=Allentiac
sai - and lang=Andoquero
sai - ayo lang=Ayomán
sai - bae lang=Baenan
sai - bag lang=Bagua
sai - bet lang=Betoi
sai - bor - pro lang=Proto-Boran
sai - cac lang=Cacán
sai - caq lang=Caranqui
sai - car - pro lang=Proto-Cariban
sai - cat lang=Catacao
sai - cer - pro lang=Proto-Cerrado
sai - chi lang=Chirino
sai - chn lang=Chaná
sai - chp lang=Chapacura
sai - chr lang=Charrua
sai - chu lang=Churuya
sai - cje - pro lang=Proto-Central
sai - cmg lang=Comechingon
sai - cno lang=Chono
sai - cnr lang=Cañari
sai - coe lang=Coeruna
sai - col lang=Colán
sai - cop lang=Copallén
sai - crd lang=Coroado
sai - ctq lang=Catuquinaru
sai - cul lang=Culli
sai - cva lang=Cueva
sai - esm lang=Esmeralda
sai - ewa lang=Ewarhuyana
sai - gam lang=Gamela
sai - gay lang=Gayón
sai - gmo lang=Guamo
sai - gue lang=Güenoa
sai - hau lang=Haush
sai - hoc - pro lang=Proto-Huitoto-Ocaina
sai - jee - pro lang=Proto-Jê
sai - jko lang=Jeikó
sai - jrj lang=Jirajara
sai - kat lang=Katembri
sai - mal lang=Malalí
sai - mar lang=Maratino
sai - mat lang=Matanawi
sai - mcn lang=Mocana
sai - men lang=Menien
sai - mil lang=Millcayac
sai - mlb lang=Malibu
sai - msk lang=Masakará
sai - muc lang=Mucuchí
sai - mue lang=Muellama
sai - muz lang=Muzo
sai - mys lang=Maynas
sai - nat lang=Natú
sai - nje - pro lang=Proto-Northern
sai - opo lang=Opón
sai - oto lang=Otomaco
sai - pal lang=Palta
sai - pam lang=Pamigua
sai - par lang=Paratió
sai - pnz lang=Panzaleo
sai - prh lang=Puruhá
sai - ptg lang=Patagón
sai - pur lang=Purukotó
sai - pyg lang=Payaguá
sai - pyk lang=Pykobjê
sai - qmb lang=Quimbaya
sai - qtm lang=Quitemo
sai - rab lang=Rabona
sai - ram lang=Ramanos
sai - sac lang=Sácata
sai - san lang=Sanaviron
sai - sap lang=Sapará
sai - sec lang=Sechura
sai - sin lang=Sinúfana
sai - sje - pro lang=Proto-Southern
sai - tab lang=Tabancale
sai - tal lang=Tallán
sai - tap lang=Tapayuna
sai - tar - pro lang=Proto-Taranoan
sai - teu lang=Teushen
sai - tim lang=Timote
sai - tpr lang=Taparita
sai - trr lang=Tarairiú
sai - wai lang=Waitaká
sai - way lang=Wayumará
sai - wit - pro lang=Proto-Witotoan
sai - wnm lang=Wanham
sai - xoc lang=Xocó
sai - yao lang=Yao
sai - yar lang=Yarumá
sai - yri lang=Yuri
sai - yup lang=Yupua
sai - yur lang=Yurumanguí
sal - pro lang=Proto-Salish
sdv - daj - pro lang=Proto-Daju
sdv - eje - pro lang=Proto-Eastern
sdv - nil - pro lang=Proto-Nilotic
sdv - nyi - pro lang=Proto-Nyima
sdv - tmn - pro lang=Proto-Taman
sem - amm lang=Ammonite
sem - amo lang=Amorite
sem - cha lang=Chaha
sem - dad lang=Dadanitic
sem - dum lang=Dumaitic
sem - has lang=Hasaitic
sem - him lang=Himyaritic
sem - his lang=Hismaic
sem - mhr lang=Muher
sem - pro lang=Proto-Semitic
sem - saf lang=Safaitic
sem - srb lang=Old
sem - tay lang=Taymanitic
sem - tha lang=Thamudic
sem - wes - pro lang=Proto-West
sio - pro lang=Proto-Siouan
sit - bok lang=Bokar
sit - cha lang=Chairel
sit - gkh lang=Gokhy
sit - hrs - pro lang=Proto-Hrusish
sit - jap lang=Japhug
sit - kha - pro lang=Proto-Kham
sit - liz lang=Lizu
sit - luu - pro lang=Proto-Luish
sit - mor lang=Moran
sit - prn lang=Puiron
sit - pro lang=Proto-Sino-Tibetan
sit - sit lang=Situ
sit - tan - pro lang=Proto-Tani
sit - tgm lang=Tangam
sit - tos lang=Tosu
sit - tsh lang=Tshobdun
sit - zbu lang=Zbu
sla - pro lang=Proto-Slavic
smi - pro lang=Proto-Samic
son - pro lang=Proto-Songhay
sqj - pro lang=Proto-Albanian
ssa - klk - pro lang=Proto-Kuliak
ssa - kom - pro lang=Proto-Koman
ssa - pro lang=Proto-Nilo-Saharan
syd - fne lang=Forest
syd - pro lang=Proto-Samoyedic
tai - pro lang=Proto-Tai
tai - swe - pro lang=Proto-Southwestern
tbq - bdg - pro lang=Proto-Bodo-Garo
tbq - kuk - pro lang=Proto-Kuki-Chin
tbq - lal - pro lang=Proto-Lalo
tbq - laz lang=Laze
tbq - lob - pro lang=Proto-Lolo-Burmese
tbq - lol - pro lang=Proto-Loloish
tbq - ngo lang=Ngochang
tbq - plg lang=Pai-lang
trk - dkh lang=Dukhan
trk - oat lang=Old
trk - pro lang=Proto-Turkic
tup - gua - pro lang=Proto-Tupi-Guarani
tup - kab lang=Kabishiana
tup - pro lang=Proto-Tupian
tuw - kkl lang=Kyakala
tuw - pro lang=Proto-Tungusic
tuw - sol lang=Solon
und - isa lang=Isaurian
und - kas lang=Kassite
und - mil lang=Milang
und - mmd lang=Mimi
und - mmn lang=Mimi
und - phi lang=Philistine
und - wji lang=Western
urj - mdv - pro lang=Proto-Mordvinic
urj - prm - pro lang=Proto-Permic
urj - pro lang=Proto-Uralic
urj - ugr - pro lang=Proto-Ugric
xgn - kha lang=Khamnigan
xgn - mgl lang=Mongghul
xgn - mgr lang=Mangghuer
xgn - pro lang=Proto-Mongolic
xme - ker lang=Kermanic
xme - kls lang=Kalasuri
xme - klt lang=Kilit
xme - mid lang=Middle
xme - old lang=Old
xme - ott lang=Old
xme - taf lang=Tafreshi
xme - ttc - pro lang=Proto-Tatic
xnd - pro lang=Proto-Na-Dene
xsc - pro lang=Proto-Scythian
xsc - sak - pro lang=Proto-Saka
xsc - skw - pro lang=Proto-Saka-Wakhi
ypk - pro lang=Proto-Yupik
zhx - min - pro lang=Proto-Min
zhx - sht lang=Shaozhou
zhx - tai lang=Taishanese
zhx - teo lang=Teochew
zle - ono lang=Old
zle - ort lang=Old
zlw - ocs lang=Old
zlw - opl lang=Old
zlw - pom lang=Pomeranian
zlw - slv lang=Slovincian
